10 10
37
1 add_more
513 room-01-udw
1625 room-01-ud
1 add_more
513 room-01-udw
1 add_more
513 room-01-udx
1 add_more
513 room-01-udz
1 add_more
1 add_more
513 room-01-udy
1 add_more
513 room-01-udy
1 add_more
513 room-01-udy
1 add_more
513 room-01-udy
1 add_more
513 room-01-udy
1 add_more
513 room-01-udy
1 add_more
513 room-01-udz
1409 room-03-ud
1 add_more
513 room-01-udy
929 room-01-ud
1 add_more
513 room-01-udy
1 add_more
513 room-01-udy
1 add_more
513 room-01-udy
929 room-01-udx
1 add_more
513 room-01-udy
3
12 12 12 12 12 12 12 12 12 28
12 12 12 12 12 12 12 12 12 28
36 37 37 37 37 38 513 514 515 28
52 53 53 53 53 54 513 514 515 28
52 53 53 53 53 54 513 514 515 12
52 53 53 53 53 54 513 514 515 12
55 39 39 39 39 56 513 514 515 516
513 514 515 516 513 516 513 514 515 28
537 514 515 514 513 516 513 514 515 28
538 514 28 514 513 516 513 514 515 28

521 521 521 521 521 521 521 521 521 0
529 529 529 529 529 529 529 529 529 0
0 0 0 0 0 0 0 0 0 0
0 0 0 0 0 0 0 0 0 0
0 0 0 0 0 0 0 0 0 521
0 0 0 0 0 0 0 0 0 529
0 0 0 0 0 0 0 0 0 0
0 0 0 0 0 0 0 0 0 0
0 0 0 0 0 0 0 0 0 0
0 0 0 0 0 0 0 0 0 0

0 0 0 0 0 0 0 750 752 0
0 0 0 0 0 0 0 758 760 0
0 0 0 0 0 0 0 766 768 0
0 0 0 0 0 0 0 0 0 0
0 0 0 0 0 0 0 0 0 0
0 0 0 0 0 0 0 0 0 0
0 0 0 0 0 0 0 0 0 0
0 0 0 0 915 916 0 0 0 0
0 0 0 0 923 924 0 0 0 0
0 0 0 0 913 914 0 0 0 0

