9 15
25
1 add_more
513 room-01-udw
1625 room-01-ud
1 add_more
513 room-01-udw
1 add_more
513 room-01-udx
1 add_more
513 room-01-udz
1 add_more
1 add_more
513 room-01-udy
1 add_more
513 room-01-udy
1 add_more
513 room-01-udy
1 add_more
513 room-01-udy
1 add_more
513 room-01-udy
1 add_more
513 room-01-udy
1 add_more
513 room-01-udz
1409 room-03-ud
4
28 14 14 14 14 14 14 14 14
28 14 14 14 14 14 14 14 14
28 1 2 3 4 1 2 3 4
28 1 2 3 4 1 2 3 4
28 1 2 3 4 1 2 3 4
28 1 2 3 4 1 2 3 4
28 1 2 3 4 1 2 3 4
14 1 2 3 4 1 2 3 4
14 1 2 3 4 1 2 3 4
1 2 3 4 1 2 3 4 1
28 36 37 37 37 37 37 38 4
28 52 53 53 53 53 53 54 4
28 52 53 53 53 53 53 54 4
28 52 53 53 53 53 53 54 4
28 52 53 53 53 53 53 54 4

0 521 521 521 521 521 521 521 521
0 529 529 529 529 529 529 529 529
0 0 0 0 0 0 0 0 0
0 0 0 0 0 0 0 0 0
0 0 0 0 0 0 0 0 0
0 0 0 0 0 0 0 0 0
0 0 0 0 0 0 0 0 0
521 0 0 0 0 0 0 0 0
529 0 0 0 0 0 0 0 0
0 0 0 0 0 0 0 0 0
0 0 0 0 0 0 0 0 0
0 0 0 0 0 0 0 0 0
0 0 0 0 0 0 0 0 0
0 0 0 0 0 0 0 0 0
0 0 0 0 0 0 0 0 0

0 0 0 0 1541 1565 1566 1567 1568
0 0 0 0 1549 1573 1574 1575 1576
0 0 0 0 1557 1581 1582 1583 1584
0 0 0 0 0 1589 1590 1591 1592
0 0 0 0 0 1597 1598 1599 1600
0 0 0 0 0 0 0 0 0
0 0 0 0 0 0 0 0 0
0 0 0 0 0 0 0 0 0
0 0 0 0 0 0 0 0 0
0 0 0 0 0 0 0 0 0
0 0 0 0 0 0 0 0 0
0 0 0 0 0 0 0 0 0
0 0 0 0 0 0 1009 1010 0
0 0 0 0 0 0 1009 1010 0
0 0 0 996 996 0 0 0 0

0 0 0 0 0 0 0 0 0
0 0 0 0 0 0 0 0 0
0 0 0 0 0 0 0 0 0
0 0 0 0 0 0 0 0 0
0 0 0 7 17 18 19 0 0
0 0 0 23 33 34 35 5 0
0 0 0 0 33 34 35 21 0
0 0 0 7 33 34 35 5 0
0 0 0 23 33 34 35 21 0
0 0 0 0 49 50 51 0 0
0 0 0 0 0 0 0 0 0
0 0 0 0 0 0 1001 1002 0
0 0 0 0 0 0 0 0 0
0 0 0 0 0 0 993 994 0
0 0 995 0 0 997 0 0 0

