9 11
2
1 add_more
513 room-01-udy
3
12 12 12 12 12 12 12 12 12
12 12 12 12 12 12 12 12 12
2 3 2 3 2 3 2 3 2
2 3 2 3 2 3 2 3 2
2 3 2 3 2 3 2 3 2
2 3 2 3 2 3 2 3 2
2 3 2 3 2 3 2 3 2
2 3 2 3 2 3 2 3 2
2 3 2 3 2 3 2 3 2
2 3 2 3 2 3 2 3 2
28 28 28 28 2 28 28 28 28

16 16 16 16 16 16 16 16 16
32 32 32 32 32 32 32 32 32
0 0 0 0 0 0 0 0 0
0 0 0 0 0 0 0 0 0
0 0 0 0 0 0 0 0 0
0 0 0 0 0 0 0 0 0
0 0 0 0 0 0 0 0 0
0 0 0 0 0 0 0 0 48
0 0 0 0 0 0 79 79 64
0 0 0 0 0 0 79 79 79
0 0 0 0 0 0 0 0 0

0 9 0 0 44 0 0 0 0
0 25 0 0 0 0 0 915 916
0 0 0 0 0 0 0 923 924
0 0 0 0 0 0 0 913 914
0 0 0 0 0 0 0 921 922
0 0 0 0 70 0 0 0 0
0 0 0 0 86 0 0 0 0
0 0 0 0 0 0 0 0 0
0 0 0 0 0 0 45 46 47
0 0 0 0 0 0 61 62 63
0 0 0 0 0 0 0 0 0

