9 10
2
1 add_more
513 room-01-udw
3
28 43 43 43 43 43 43 43 43
28 43 43 43 43 43 43 43 43
28 77 77 77 77 77 77 77 77
28 77 77 77 77 77 77 77 77
28 77 77 77 77 77 77 77 77
28 77 77 77 77 77 77 77 77
43 77 77 77 77 77 77 77 77
43 77 77 77 77 77 77 77 77
77 77 77 77 77 77 77 77 77
28 77 77 77 77 77 77 77 77

0 11 11 11 11 11 11 11 11
0 27 27 27 27 27 27 27 27
0 0 0 0 0 0 0 0 0
0 0 0 0 0 0 0 0 0
0 0 0 0 0 0 0 0 0
0 0 0 0 0 0 0 0 0
11 0 0 0 0 0 0 0 0
27 0 0 0 0 0 0 0 0
0 0 0 0 0 0 0 0 0
0 0 0 0 0 0 0 0 0

0 109 110 111 0 0 0 0 0
0 125 126 127 0 0 0 0 0
0 0 0 0 0 70 0 0 0
0 0 0 0 0 86 0 0 0
0 609 610 610 610 610 0 0 611
0 617 618 618 618 618 0 0 619
0 0 0 0 0 0 0 0 0
0 0 0 0 0 0 0 0 0
0 0 0 0 0 0 0 0 0
0 0 0 0 0 0 0 0 0

