11 12
40
1 add_more
513 room-01-udw
1625 room-01-ud
1 add_more
513 room-01-udw
1 add_more
513 room-01-udx
1 add_more
513 room-01-udz
1 add_more
1 add_more
513 room-01-udy
1 add_more
513 room-01-udy
1 add_more
513 room-01-udy
1 add_more
513 room-01-udy
1 add_more
513 room-01-udy
1 add_more
513 room-01-udy
1 add_more
513 room-01-udz
1409 room-03-ud
1 add_more
513 room-01-udy
929 room-01-ud
1 add_more
513 room-01-udy
1 add_more
513 room-01-udy
1 add_more
513 room-01-udy
929 room-01-udx
1 add_more
513 room-01-udy
1 add_more
513 room-01-udw3
697 room-01-udx
3
701 701 701 701 701 701 701 701 701 701 701
701 701 701 701 701 701 701 701 701 701 701
513 514 515 516 513 514 515 516 513 514 515
513 514 515 516 513 514 515 516 513 514 515
513 514 515 516 513 514 515 516 513 514 515
513 514 515 516 513 514 515 516 513 514 515
513 514 515 516 513 514 515 516 513 514 515
513 514 515 516 513 514 515 516 513 514 515
513 514 515 516 513 514 515 516 513 514 515
513 514 515 516 513 514 515 516 513 514 515
513 514 515 516 513 514 515 516 513 514 515
28 28 28 28 28 514 28 28 28 28 28

521 521 521 521 521 521 521 521 521 521 521
529 529 529 529 529 529 529 529 529 529 529
0 0 0 0 0 0 0 0 0 0 0
0 0 0 0 0 0 0 0 0 0 0
0 0 0 0 0 0 0 0 0 0 0
0 0 0 0 0 0 0 0 0 0 0
0 0 0 0 0 0 0 0 0 0 0
0 0 0 0 0 0 0 0 0 0 0
0 0 0 0 0 0 0 0 0 0 0
0 0 0 0 0 0 0 0 0 0 0
0 0 0 0 0 0 0 0 0 0 0
0 0 0 0 0 0 0 0 0 0 0

0 0 0 0 0 0 0 0 0 591 1792
1802 1803 0 0 0 0 0 0 0 591 1800
1810 1811 0 0 0 0 0 0 0 591 1808
0 0 0 0 0 0 0 0 0 0 0
0 0 0 0 0 0 0 0 0 0 0
0 0 0 0 0 1605 1606 0 0 0 0
0 0 0 0 0 1613 1614 0 0 0 0
0 0 0 0 0 0 0 0 0 0 0
0 0 0 0 0 0 0 0 0 0 0
0 0 0 0 0 0 0 0 0 0 0
0 0 0 0 0 0 0 0 0 0 0
0 0 0 0 0 0 0 0 0 0 0

