house1_basement1
14 19
3
1 add_more
513 room-01-udw
1625 room-01-ud
4
0 0 0 0 0 0 0 0 0 0 0 0 0 0
0 0 0 0 0 0 0 0 0 0 0 0 0 0
0 0 0 0 0 0 0 0 0 0 0 0 0 0
0 312 312 312 312 312 312 312 312 312 312 312 312 0
0 312 312 312 312 312 312 312 312 312 312 312 312 0
312 312 312 312 312 312 312 312 312 312 312 312 312 312
0 312 312 312 312 312 312 312 312 312 312 312 312 0
0 312 312 312 312 312 312 312 312 312 312 312 312 0
0 312 312 312 312 312 312 0 0 0 0 0 0 0
0 312 312 312 312 312 312 312 312 312 312 312 312 0
0 312 312 312 312 312 312 312 312 312 312 312 312 0
0 312 312 312 312 312 312 312 312 312 312 312 312 0
0 312 312 312 312 312 312 312 312 312 312 312 312 0
0 312 312 312 312 312 312 0 0 0 0 0 0 0
0 312 312 312 312 312 312 312 312 312 312 312 312 0
0 312 312 312 312 312 312 312 312 312 312 312 312 0
0 312 312 312 312 312 312 312 312 312 312 312 312 0
0 0 0 312 0 0 0 0 0 0 0 0 0 0
0 0 0 0 0 0 0 0 0 0 0 0 0 0

28 12 12 12 12 12 12 12 12 12 12 12 12 28
28 12 12 12 12 12 12 12 12 12 12 12 12 28
12 12 12 12 12 12 12 12 12 12 12 12 12 12
12 77 78 77 78 77 78 77 78 77 78 77 78 12
12 77 78 77 78 77 78 77 78 77 78 77 78 12
78 77 78 77 78 77 78 77 78 77 78 77 78 77
28 77 78 77 78 77 78 77 78 77 78 77 78 28
28 77 78 77 78 77 78 77 78 77 78 77 78 28
28 77 78 77 78 77 78 77 78 77 78 77 78 28
28 77 78 77 78 77 78 77 78 77 78 77 78 28
28 77 78 77 78 77 78 77 78 77 78 77 78 28
28 77 78 77 78 77 78 77 78 77 78 77 78 28
28 77 78 77 78 77 78 77 78 77 78 77 78 28
28 77 78 77 78 77 78 77 78 77 78 77 78 28
28 77 78 77 78 77 78 77 78 77 78 77 78 28
28 77 78 77 78 77 78 77 78 77 78 77 78 28
28 77 78 77 78 77 78 77 78 77 78 77 78 28
28 28 28 93 28 28 28 28 28 28 28 28 28 28
28 28 28 93 28 28 28 28 28 28 28 28 28 28

0 11 11 11 11 11 11 11 11 11 11 11 11 0
0 0 0 0 0 0 0 0 0 0 0 0 0 0
11 27 27 27 27 27 27 27 27 27 27 27 27 11
0 0 0 0 0 0 0 0 0 0 0 0 0 0
27 0 0 0 0 0 0 0 0 0 0 0 0 27
0 0 0 0 0 0 0 0 0 0 0 0 0 0
0 0 0 0 0 0 0 0 0 0 0 0 0 0
0 0 0 0 0 0 0 0 0 0 0 0 0 0
0 0 0 0 0 0 0 0 0 0 0 0 0 0
0 0 0 0 0 0 0 0 0 0 0 0 0 0
0 0 0 0 0 0 0 0 0 0 0 0 0 0
0 0 0 0 0 0 0 0 0 0 0 0 0 0
0 0 0 0 0 0 0 0 0 0 0 0 0 0
0 0 0 0 0 0 0 0 0 0 0 0 0 0
0 0 0 0 0 0 0 0 0 0 0 0 0 0
0 0 0 0 0 0 0 0 0 0 0 0 0 0
0 0 0 0 0 0 0 0 0 0 0 0 0 0
0 0 0 0 0 0 0 0 0 0 0 0 0 0
0 0 0 0 0 0 0 0 0 0 0 0 0 0

0 0 0 0 0 0 0 0 0 0 0 0 0 0
0 0 0 0 0 0 0 0 0 0 0 0 0 0
0 0 0 0 0 0 0 0 0 0 0 0 0 0
0 0 0 0 0 0 0 0 0 0 0 0 0 0
0 0 0 0 0 0 0 0 0 0 0 0 0 0
0 0 0 0 0 0 0 1900 1901 1902 1900 1901 1902 0
0 0 0 0 0 0 0 1908 1909 1910 1908 1909 1910 0
0 0 0 0 0 0 0 1916 1917 1918 1916 1917 1918 0
0 0 0 0 0 0 0 1924 1925 1926 1924 1925 1926 0
0 0 0 0 0 0 0 0 0 0 0 0 0 0
0 0 0 0 0 0 0 1900 1901 1902 1900 1901 1902 0
0 0 0 0 0 0 0 1908 1909 1910 1908 1909 1910 0
0 0 0 0 0 0 0 1916 1917 1918 1916 1917 1918 0
0 0 0 0 0 0 0 1924 1925 1926 1924 1925 1926 0
0 0 0 0 0 0 0 0 0 0 0 0 0 0
0 0 0 0 0 0 0 1876 1877 1878 1876 1877 1878 0
0 0 0 0 0 0 0 1884 1885 1886 1884 1885 1886 0
0 0 0 0 0 0 0 0 0 0 0 0 0 0
0 0 0 0 0 0 0 0 0 0 0 0 0 0

