house1_library
16 22
3
1 add_more
513 room-01-udy
929 room-01-ud
6
0 0 0 0 0 0 0 0 0 0 0 0 0 0 0 0
0 0 0 0 0 0 0 0 0 0 0 0 0 0 0 0
312 312 312 312 312 312 312 312 312 312 312 312 312 312 312 312
312 312 312 312 312 312 312 312 312 312 312 312 312 312 312 312
0 0 0 0 0 0 312 312 312 312 0 0 0 0 0 0
312 312 312 312 312 312 312 312 312 312 312 312 312 312 312 312
312 312 312 312 312 312 312 312 312 312 312 312 312 312 312 312
312 312 312 312 312 312 312 312 312 312 312 312 312 312 312 312
0 0 0 312 312 312 312 312 312 312 0 0 0 0 0 0
312 312 312 312 312 312 312 312 312 312 312 312 312 312 312 312
312 312 312 312 312 312 312 312 312 312 312 312 312 312 312 312
312 312 312 312 312 312 312 0 0 0 0 0 0 0 0 0
0 0 0 0 312 312 312 312 312 312 312 312 312 312 312 312
0 0 0 0 312 312 312 312 312 312 312 312 312 312 312 312
0 0 0 0 312 312 312 312 312 312 312 312 312 312 312 312
0 0 0 0 312 312 312 0 0 0 0 0 0 0 0 0
0 0 0 0 312 312 312 312 312 312 312 312 312 312 312 312
0 0 0 0 312 312 312 312 312 312 312 312 312 312 312 312
312 312 312 312 312 312 312 312 312 312 312 312 312 312 312 312
0 0 0 0 0 0 0 0 0 0 0 0 0 312 312 312
0 0 0 0 0 0 0 0 0 0 0 0 0 312 312 312
0 0 0 0 0 0 0 0 0 0 0 0 0 0 312 0

12 12 12 12 12 12 12 12 12 12 12 12 12 12 12 12
12 12 12 12 12 12 12 12 12 12 12 12 12 12 12 12
513 514 515 516 513 514 515 516 513 514 515 516 513 514 515 516
513 514 515 516 513 514 515 516 513 514 515 516 513 514 515 516
513 514 515 516 513 514 515 516 513 514 515 516 513 514 515 516
513 514 515 516 513 514 515 516 513 514 515 516 513 514 515 516
513 514 515 516 513 514 515 516 513 514 515 516 513 514 515 516
513 514 515 516 513 514 515 516 513 514 515 516 513 514 515 516
513 514 515 516 513 514 515 516 513 514 515 516 513 514 515 516
513 514 515 516 513 514 515 516 513 514 515 516 513 514 515 516
513 514 515 516 513 514 515 516 513 514 515 516 513 514 515 516
513 514 515 516 513 514 515 516 513 514 515 516 513 514 515 516
513 514 515 516 513 514 515 516 513 514 515 516 513 514 515 516
513 514 515 516 513 514 515 516 513 514 515 516 513 514 515 516
513 514 515 516 513 514 515 516 513 514 515 516 513 514 515 516
513 514 515 516 513 514 515 516 513 514 515 516 513 514 515 516
513 514 515 516 513 514 515 516 513 514 515 516 513 514 515 516
513 514 515 516 513 514 515 516 513 514 515 516 513 514 515 516
513 514 515 516 513 514 515 516 513 514 515 516 513 514 515 516
28 28 28 28 28 28 28 28 28 28 28 28 28 514 515 516
28 28 28 28 28 28 28 28 28 28 28 28 28 514 515 516
28 28 28 28 28 28 28 28 28 28 28 28 28 28 515 28

521 521 521 521 521 521 521 521 521 521 521 521 521 521 521 521
529 529 529 529 529 529 529 529 529 529 529 529 529 529 529 529
0 0 0 0 0 0 0 0 0 0 0 0 0 0 0 0
0 0 0 0 0 0 0 0 0 0 0 0 0 0 0 0
0 0 0 0 0 0 0 0 0 0 0 0 0 0 0 0
0 0 0 0 0 0 0 0 0 0 0 0 0 0 0 0
0 0 0 0 0 0 0 0 0 0 0 0 0 0 0 0
0 0 0 0 0 0 0 0 0 0 0 0 0 0 0 0
0 0 0 0 0 0 0 0 0 0 0 0 0 0 0 0
0 0 0 0 0 0 0 0 0 0 0 0 0 0 0 0
0 0 0 0 0 0 0 0 0 0 0 0 0 0 0 0
0 0 0 0 0 0 0 0 0 0 0 0 0 0 0 0
0 0 0 0 0 0 0 0 0 0 0 0 0 0 0 0
0 0 0 0 0 0 0 0 0 0 0 0 0 0 0 0
0 0 0 0 0 0 0 0 0 0 0 0 0 0 0 0
0 0 0 0 0 0 0 0 0 0 0 0 0 0 0 0
0 0 0 0 0 0 0 0 0 0 0 0 0 0 0 0
0 0 0 0 0 0 0 0 0 0 0 0 0 0 0 0
0 0 0 0 0 0 0 0 0 0 0 0 0 0 0 0
0 0 0 0 0 0 0 0 0 0 0 0 0 0 0 0
0 0 0 0 0 0 0 0 0 0 0 0 0 0 0 0
0 0 0 0 0 0 0 0 0 0 0 0 0 0 0 0

0 0 0 0 0 0 0 0 0 0 0 0 0 0 0 0
0 0 0 0 0 0 0 0 0 0 0 0 0 0 0 0
0 0 0 0 0 0 0 0 0 0 0 0 0 0 0 0
0 0 0 0 0 0 0 0 0 0 0 0 0 0 0 0
1225 1226 1227 1225 1226 1227 0 0 0 0 1225 1226 1227 1225 1226 1227
1233 1234 1235 1233 1234 1235 0 0 0 0 1233 1234 1235 1233 1234 1235
0 0 0 0 0 0 0 0 0 0 0 0 0 0 0 0
0 0 0 0 0 0 0 0 0 0 0 0 0 0 0 0
1225 1226 1227 0 0 0 0 0 0 0 1225 1226 1227 1225 1226 1227
1233 1234 1235 0 0 0 0 0 0 0 1233 1234 1235 1233 1234 1235
0 0 0 0 0 0 0 0 0 0 0 0 0 0 0 0
0 0 0 0 0 0 0 1169 1170 1171 1169 1170 1171 1193 1194 1195
1278 1278 1278 1279 0 0 0 1177 1178 1179 1177 1178 1179 1201 1202 1203
1278 1278 1278 1267 0 0 0 0 0 0 0 0 0 0 0 0
1278 1278 1278 1267 0 0 0 0 0 0 0 0 0 0 0 0
1278 1278 1278 1267 0 0 0 1225 1226 1227 1225 1226 1227 1225 1226 1227
1278 1278 1278 1279 0 0 0 1233 1234 1235 1233 1234 1235 1233 1234 1235
1285 1286 1286 1287 0 0 0 0 0 0 0 0 0 0 0 0
0 0 0 0 0 0 0 0 0 0 0 0 0 0 0 0
0 0 0 0 0 0 0 0 0 0 0 0 0 0 0 0
0 0 0 0 0 0 0 0 0 0 0 0 0 0 0 0
0 0 0 0 0 0 0 0 0 0 0 0 0 0 0 0

0 0 0 0 0 0 0 0 0 0 0 0 0 0 0 0
0 0 0 0 0 0 0 0 0 0 0 0 0 0 0 0
0 0 0 0 0 0 0 0 0 0 0 0 0 0 0 0
0 0 0 0 0 0 0 0 0 0 0 0 0 0 0 0
0 0 0 0 0 0 0 0 0 0 0 0 0 0 0 0
0 0 0 0 0 0 0 0 0 0 0 0 0 0 0 0
0 0 0 0 0 0 0 0 0 0 0 0 0 0 0 0
0 0 0 0 0 0 0 0 0 0 0 0 0 0 0 0
0 0 0 0 0 0 0 0 0 0 0 0 0 0 0 0
0 0 0 0 0 0 0 0 0 0 0 0 0 0 0 0
0 0 0 0 0 0 0 0 0 0 0 0 0 0 0 0
0 0 0 0 0 0 0 0 0 0 0 0 0 0 0 0
0 1155 1156 0 0 0 0 0 0 0 0 0 0 0 0 0
0 0 0 0 0 0 0 0 0 0 0 0 0 0 0 0
0 0 0 0 0 0 0 0 0 0 0 0 0 0 0 0
0 1153 1154 0 0 0 0 0 0 0 0 0 0 0 0 0
0 1161 1162 0 0 0 0 0 0 0 0 0 0 0 0 0
0 0 0 0 0 0 0 0 0 0 0 0 0 0 0 0
0 0 0 0 0 0 0 0 0 0 0 0 0 0 0 0
0 0 0 0 0 0 0 0 0 0 0 0 0 0 0 0
0 0 0 0 0 0 0 0 0 0 0 0 0 0 0 0
0 0 0 0 0 0 0 0 0 0 0 0 0 0 0 0

0 0 0 0 0 0 0 0 0 0 0 0 0 0 0 0
0 0 0 0 0 0 0 0 0 0 0 0 0 0 0 0
1209 1210 1211 1209 1210 1211 0 0 0 0 1209 1210 1211 1209 1210 1211
1217 1218 1219 1217 1218 1219 0 0 0 0 1217 1218 1219 1217 1218 1219
0 0 0 0 0 0 0 0 0 0 0 0 0 0 0 0
0 0 0 0 0 0 0 0 0 0 0 0 0 0 0 0
1209 1210 1211 0 0 0 0 0 0 0 1209 1210 1211 1209 1210 1211
1217 1218 1219 0 0 0 0 0 0 0 1217 1218 1219 1217 1218 1219
0 0 0 0 0 0 0 0 0 0 0 0 0 0 0 0
0 0 0 0 0 0 0 0 0 0 0 0 0 0 0 0
0 0 0 0 0 0 0 0 0 0 0 0 0 1209 1210 1211
1270 1270 1270 1271 0 0 0 0 0 0 0 0 0 0 0 0
0 0 0 0 0 0 0 0 0 0 0 0 0 0 0 0
0 0 0 0 0 0 0 1209 1210 1211 1209 1210 1211 1209 1210 1211
0 0 0 0 0 0 0 1217 1218 1219 1217 1218 1219 1217 1218 1219
0 0 0 0 0 0 0 0 0 0 0 0 0 0 0 0
0 0 0 0 0 0 0 0 0 0 0 0 0 0 0 0
0 0 0 0 0 0 0 0 0 0 0 0 0 0 0 0
0 0 0 0 0 0 0 0 0 0 0 0 0 0 0 0
0 0 0 0 0 0 0 0 0 0 0 0 0 0 0 0
0 0 0 0 0 0 0 0 0 0 0 0 0 0 0 0
0 0 0 0 0 0 0 0 0 0 0 0 0 0 0 0

