house1_hallway6
15 15
2
1 add_more
513 room-01-udy
3
28 28 28 28 28 28 28 28 28 28 28 28 28 28 28
28 28 28 28 28 28 28 28 28 28 28 28 28 28 28
28 28 28 28 28 28 28 28 28 28 28 28 28 28 28
28 28 28 28 28 28 28 28 28 28 28 28 28 28 28
28 28 28 28 28 28 28 28 28 28 28 28 28 28 28
28 28 28 28 28 28 28 28 28 28 28 28 28 28 28
28 28 28 28 28 28 28 28 28 28 28 28 28 28 28
28 28 28 28 28 28 28 28 28 28 28 28 28 28 28
28 28 28 28 28 28 28 28 28 28 28 28 28 28 28
28 28 28 28 28 28 28 28 28 28 28 28 28 28 28
12 28 28 28 28 28 28 12 12 12 12 12 12 12 12
12 28 28 28 28 28 28 12 12 12 12 12 12 12 12
513 514 515 516 513 514 515 516 513 514 515 516 513 514 515
513 514 515 516 513 514 515 516 513 514 515 516 513 514 515
513 514 515 516 513 514 515 516 513 514 515 516 513 514 515

0 0 0 0 0 0 0 0 0 0 0 0 0 0 0
0 0 0 0 0 0 0 0 0 0 0 0 0 0 0
0 0 0 0 0 0 0 0 0 0 0 0 0 0 0
0 161 162 163 164 165 166 0 0 0 0 0 0 0 0
0 177 178 179 180 181 182 0 0 0 0 0 0 0 0
0 193 194 195 196 197 198 0 0 0 0 0 0 0 0
0 209 210 211 212 213 214 0 0 0 0 0 0 0 0
0 225 226 227 228 229 230 0 0 0 0 0 0 0 0
0 241 242 243 244 245 246 0 0 0 0 0 0 0 0
0 0 0 0 0 0 0 0 0 0 0 0 0 0 0
0 257 258 259 260 261 262 0 0 0 0 0 0 0 0
0 273 274 275 276 277 278 0 0 0 0 0 0 0 0
0 0 0 0 0 0 0 0 0 0 0 0 0 0 0
0 0 0 0 0 0 0 0 0 0 0 0 0 0 0
0 0 0 0 0 0 0 0 0 0 0 0 0 0 0

0 0 0 0 0 0 0 0 0 0 0 0 0 0 0
0 0 0 0 0 0 0 0 0 0 0 0 0 0 0
0 0 0 0 0 0 0 0 0 0 0 0 0 0 0
0 0 0 0 0 0 0 0 0 0 0 0 0 0 0
0 0 0 0 0 0 0 0 0 0 0 0 0 0 0
0 0 0 0 0 0 0 0 0 0 0 0 0 0 0
0 0 0 0 0 0 0 0 0 0 0 0 0 0 0
0 0 0 0 0 0 0 0 0 0 0 0 0 0 0
0 0 0 0 0 0 0 0 0 0 0 0 0 0 0
0 71 72 73 71 72 73 0 0 0 0 0 0 0 0
0 87 88 89 87 88 89 0 0 0 0 0 0 0 0
0 0 0 0 0 0 0 0 0 0 0 0 0 0 0
0 0 0 0 0 0 0 0 0 0 0 0 0 0 0
0 0 0 0 0 0 0 0 0 0 0 0 0 0 0
0 0 0 0 0 0 0 0 0 0 0 0 0 0 0

