house1_basement2
8 8
2
1 add_more
513 room-01-udw
5
0 0 0 0 0 0 0 0
0 0 0 0 0 0 0 0
0 0 0 312 312 312 312 0
312 312 312 312 312 312 312 0
312 312 312 312 312 312 312 312
312 312 312 312 312 312 312 0
312 312 312 312 312 312 312 0
0 0 0 312 312 312 312 0

28 28 28 43 43 43 43 28
43 43 43 43 43 43 43 28
43 43 43 77 78 77 78 43
78 77 78 77 78 77 78 43
78 77 78 77 78 77 78 77
78 77 78 77 78 77 78 28
78 77 78 77 78 77 78 28
78 77 78 77 78 77 78 28

0 0 0 11 11 11 11 0
11 11 11 27 27 27 27 0
27 27 27 0 0 0 0 11
0 0 0 0 0 0 0 27
0 0 0 0 0 0 0 0
0 0 0 0 0 0 0 0
0 0 0 0 0 0 0 0
0 0 0 0 0 0 0 0

0 0 1208 0 0 0 0 0
1215 1215 1216 0 0 1226 1227 0
1223 1223 1224 0 0 1234 1235 0
1231 1231 1232 0 0 0 0 0
0 0 0 0 0 0 0 0
0 0 0 0 0 0 0 0
0 0 0 0 0 0 0 0
1037 1038 1039 0 0 0 0 0

0 0 0 0 0 0 0 0
0 0 0 0 0 0 0 0
0 0 0 0 0 0 0 0
0 0 0 0 0 0 0 0
0 0 0 0 0 0 0 0
0 0 0 0 0 0 0 0
1029 1030 1031 0 0 0 0 0
0 0 0 0 0 0 0 0

