house1_room1
9 11
2
1 add_more
513 room-01-udy
3
12 12 12 12 12 12 12 12 12
12 12 12 12 12 12 12 12 12
514 515 516 513 514 515 516 513 514
514 515 516 513 514 515 516 513 514
514 515 516 513 514 515 516 513 514
514 65 66 66 66 67 516 513 514
514 81 82 82 82 83 516 513 514
514 81 82 82 82 83 516 513 514
514 97 98 98 98 99 516 513 514
514 515 516 513 514 515 516 513 514
28 28 28 28 514 28 28 28 28

521 521 521 521 521 521 521 521 521
529 529 529 529 529 529 529 529 529
0 0 0 0 0 0 0 0 0
0 0 0 0 0 0 0 0 0
0 0 0 0 0 0 0 0 0
0 0 0 0 0 0 0 0 0
0 0 0 0 0 0 0 0 0
0 0 0 0 0 0 0 0 0
0 0 0 0 0 0 0 0 0
0 0 0 0 0 0 0 0 0
0 0 0 0 0 0 0 0 0

0 0 0 0 846 847 848 68 69
0 858 859 0 854 855 856 84 85
0 866 867 0 862 863 864 100 101
0 0 0 0 0 0 0 0 0
0 0 0 0 0 0 0 0 0
0 0 0 0 0 0 0 0 0
0 0 0 0 0 0 0 0 0
0 0 0 0 0 0 0 915 916
0 0 0 0 0 0 0 923 924
0 0 0 0 0 0 0 913 914
0 0 0 0 0 0 0 0 0

