house1_lobby
13 13
2
1 add_more
513 room-01-udy
4
0 0 0 0 0 0 0 0 0 0 0 0 0
0 0 0 0 0 0 0 0 0 0 0 0 0
0 0 0 0 312 312 312 0 0 0 0 0 0
0 0 0 0 312 312 312 0 0 0 0 0 0
0 0 0 0 312 312 312 0 0 0 0 0 0
0 0 0 0 312 312 312 312 312 312 0 0 0
312 312 312 312 312 312 312 312 312 312 312 312 312
312 312 312 312 312 312 312 312 312 312 312 312 312
312 312 312 312 312 312 312 312 312 312 312 312 312
0 0 0 312 312 312 312 312 312 312 0 0 0
0 0 0 312 312 312 312 312 312 312 0 0 0
0 0 0 312 312 312 312 312 312 312 0 0 0
0 0 0 0 0 0 312 0 0 0 0 0 0

28 28 28 28 12 12 12 28 28 28 28 28 28
28 28 28 28 12 12 12 28 28 28 28 28 28
28 28 28 28 513 514 515 28 28 28 28 28 28
28 28 28 28 513 514 515 12 28 28 28 28 28
12 12 12 12 513 514 515 12 28 28 12 12 12
12 12 12 12 513 514 515 516 513 514 12 12 12
513 514 515 516 513 514 515 516 513 514 515 516 513
513 514 515 516 513 514 515 516 513 514 515 516 513
513 514 515 516 513 514 515 516 513 514 515 516 513
28 28 28 513 514 515 516 513 514 515 28 28 28
28 28 28 13 13 13 13 13 13 13 28 28 28
28 28 28 13 13 13 13 13 13 13 28 28 28
28 28 28 28 28 28 13 28 28 28 28 28 28

0 0 0 0 521 521 521 0 0 0 0 0 0
0 0 0 0 529 529 529 0 0 0 0 0 0
0 0 0 0 0 0 0 0 0 0 0 0 0
0 0 0 0 0 0 0 521 0 0 0 0 0
521 521 521 521 0 0 0 529 0 0 521 521 521
529 529 529 529 0 0 0 0 0 0 529 529 529
0 0 0 0 0 0 0 0 0 0 0 0 0
0 0 0 0 0 0 0 0 0 0 0 0 0
0 0 0 0 0 0 0 0 0 0 0 0 0
0 0 0 0 0 0 0 0 0 0 0 0 0
0 0 0 540 540 540 540 540 540 540 0 0 0
0 0 0 0 0 0 0 0 0 0 0 0 0
0 0 0 0 0 0 0 0 0 0 0 0 0

0 0 0 0 0 9 0 0 569 569 0 0 0
0 0 0 0 0 25 0 0 569 569 0 0 0
0 0 0 0 0 0 0 0 569 569 0 0 0
0 0 0 0 0 0 0 0 569 569 0 0 0
0 0 0 0 0 0 0 559 569 569 0 0 0
0 0 0 0 0 0 0 575 577 577 0 0 0
0 0 0 0 0 0 0 0 0 0 0 0 0
0 0 0 0 0 0 0 0 0 0 0 0 0
0 0 0 0 0 0 0 0 0 0 0 0 0
0 0 0 0 0 0 0 0 0 0 0 0 0
0 0 0 0 0 0 0 0 0 0 0 0 0
0 0 0 0 0 0 0 0 0 0 0 0 0
0 0 0 0 0 0 0 0 0 0 0 0 0

