house2_basement1 23
12 11
2
1 room-01-udz
897 add_more
4
0 0 0 0 0 0 0 0 0 0 0 0
0 0 0 0 0 0 0 0 0 0 0 0
1208 1208 1208 1208 1208 1208 1208 1208 1208 1208 0 0
1208 1208 1208 1208 1208 1208 1208 1208 1208 1208 0 0
1208 1208 1208 1208 1208 1208 1208 1208 1208 1208 0 0
1208 1208 1208 1208 1208 1208 1208 1208 1208 1208 0 0
1208 1208 1208 1208 1208 1208 1208 1208 1208 1208 1208 1208
1208 1208 1208 1208 1208 1208 1208 1208 1208 1208 1208 1208
1208 1208 1208 1208 1208 1208 1208 1208 1208 1208 1208 1208
1208 1208 1208 1208 1208 1208 1208 1208 1208 1208 1208 1208
1208 1208 1208 1208 1208 1208 1208 1208 1208 1208 1208 1208

10 7 7 11 7 7 7 7 7 12 924 924
18 7 7 19 7 7 7 7 7 7 924 924
2 3 2 3 2 3 2 3 2 2 924 924
2 3 2 3 2 3 2 3 2 2 924 924
2 3 2 3 2 3 2 3 2 2 924 924
2 3 2 3 2 3 2 3 2 2 924 924
2 3 2 3 2 3 2 3 2 2 3 2
2 3 2 3 2 3 2 3 2 2 3 2
2 3 2 3 2 3 2 3 2 2 3 2
2 3 2 3 2 3 2 3 2 2 3 2
2 3 2 3 2 3 2 3 2 2 3 2

9 9 9 9 9 9 9 9 9 9 0 0
17 17 17 17 17 17 17 17 17 17 0 0
0 0 0 0 0 0 0 0 0 0 0 0
0 0 0 0 0 0 0 0 0 0 0 0
0 0 0 0 0 0 0 0 0 0 0 0
0 0 0 0 0 0 0 0 0 0 0 0
0 0 0 0 0 0 0 0 0 0 0 0
0 0 0 0 0 0 0 0 0 0 0 0
0 0 0 0 0 0 0 0 0 0 0 0
0 0 0 0 0 0 0 0 0 0 0 0
0 0 0 0 0 0 0 0 0 0 0 0

0 0 0 0 0 905 0 0 0 47 0 0
0 0 0 0 0 921 0 0 0 47 57 57
0 0 0 0 0 0 0 0 0 47 57 57
0 0 0 0 0 0 0 0 0 47 57 57
0 0 0 0 0 0 0 0 0 47 57 57
0 0 0 0 0 0 0 0 0 47 57 57
0 0 0 0 0 0 0 0 0 63 65 65
0 0 0 0 0 0 0 0 0 0 0 0
0 0 0 0 0 0 0 0 0 0 0 0
0 0 0 0 0 0 0 0 0 0 0 0
0 0 0 0 0 0 0 0 0 0 0 0

