house1_room8
9 11
3
1 add_more
513 room-01-udy
929 room-01-udx
5
0 0 0 0 0 0 0 0 0
0 0 0 0 0 0 0 0 0
312 312 312 312 312 312 312 0 0
312 312 312 312 312 312 312 0 0
312 312 312 312 312 312 312 0 0
312 312 312 312 312 312 312 312 312
312 312 312 312 0 312 312 312 312
312 312 312 312 312 312 312 312 312
312 312 312 312 312 312 312 312 0
312 312 312 312 312 312 0 0 0
0 0 0 0 312 0 0 0 0

12 12 12 12 12 12 12 12 12
12 12 12 12 12 12 12 12 12
2 3 2 3 2 3 2 3 2
2 3 2 3 2 3 2 3 2
2 3 2 3 2 3 2 3 2
2 3 2 3 2 3 2 3 2
2 3 2 3 2 3 2 3 2
2 3 2 3 2 3 2 3 2
2 3 2 3 2 3 2 3 2
2 3 2 3 2 3 2 3 2
28 28 28 28 2 28 28 28 28

16 16 16 16 16 16 16 16 16
32 32 32 32 32 32 32 32 32
0 0 0 0 0 0 0 0 0
0 0 0 0 0 0 0 0 0
0 0 0 0 0 0 0 0 0
0 0 0 0 0 0 0 0 0
0 0 0 0 0 0 0 0 0
0 0 0 0 0 0 0 0 48
0 0 0 0 0 0 0 0 64
0 0 0 0 0 0 0 0 0
0 0 0 0 0 0 0 0 0

0 9 0 0 44 0 0 0 0
0 25 0 0 0 0 0 915 916
0 0 0 0 0 0 0 923 924
0 0 0 0 0 0 0 913 914
0 0 0 0 0 0 0 921 922
0 0 0 0 0 0 0 0 0
0 0 0 0 86 0 0 0 0
0 0 0 0 0 0 0 0 0
0 0 0 0 0 0 0 0 1767
0 0 0 0 0 0 1773 1774 1775
0 0 0 0 0 0 0 0 0

0 0 0 0 0 0 0 0 0
0 0 0 0 0 0 0 0 0
0 0 0 0 0 0 0 0 0
0 0 0 0 0 0 0 0 0
0 0 0 0 0 0 0 0 0
0 0 0 0 70 0 0 0 0
0 0 0 0 0 0 0 0 0
0 0 0 0 0 0 0 0 0
0 0 0 0 0 0 1765 1766 0
0 0 0 0 0 0 0 0 0
0 0 0 0 0 0 0 0 0

