house2_basement7
8 8
2
1 room-01-udz
897 add_more
4
0 0 0 0 0 0 0 0
0 0 0 0 0 0 0 0
1208 1208 1208 1208 1208 1208 1208 0
1208 1208 1208 1208 1208 1208 1208 0
1208 1208 1208 1208 1208 1208 1208 1208
1208 1208 1208 1208 1208 1208 1208 0
1208 1208 1208 1208 1208 1208 1208 0
1208 1208 1208 1208 1208 1208 1208 0

10 7 7 7 11 7 7 924
7 7 7 7 19 7 7 924
1 2 1 2 1 2 1 7
1 2 961 962 963 2 1 7
1 2 977 978 979 2 1 2
1 2 977 978 979 2 1 924
1 2 1 994 995 2 1 924
1 2 1 2 1 2 1 924

9 9 9 9 9 9 9 0
17 17 17 17 17 17 17 0
0 0 0 0 0 0 0 9
0 0 0 0 0 0 0 17
0 0 0 0 0 0 0 0
0 0 0 0 0 0 0 0
0 0 0 0 0 0 0 0
0 0 0 0 0 0 0 0

0 0 0 0 0 0 0 0
884 0 0 0 0 0 0 0
892 0 0 0 0 0 0 0
0 0 0 0 0 0 0 0
0 0 0 0 0 0 0 0
0 0 0 0 0 0 0 0
0 0 0 0 0 0 0 0
0 0 0 0 0 0 0 0

