house1_basement3 2
11 10
2
1 add_more
513 room-01-udx
4
0 0 0 0 0 0 0 0 0 0 0
0 0 0 0 0 0 0 0 0 0 0
0 312 312 312 312 312 312 312 312 312 0
0 312 312 312 312 312 312 312 312 312 0
0 312 312 312 312 312 312 312 312 312 0
312 312 312 312 312 312 312 312 312 312 312
0 312 312 312 312 312 312 312 312 312 0
0 312 312 312 312 312 312 312 312 312 0
0 312 312 312 312 312 312 312 312 312 0
0 312 312 312 312 312 312 312 312 312 0

28 43 43 43 43 43 43 43 43 43 28
28 43 43 43 43 43 43 43 43 43 28
28 77 78 77 78 77 78 77 78 78 28
43 77 78 77 78 77 78 77 78 78 43
43 77 78 65 66 66 66 67 78 78 43
78 77 78 81 82 82 82 83 78 78 77
28 77 78 81 82 82 82 83 78 78 28
28 77 78 97 98 98 98 99 78 78 28
28 77 78 77 78 77 78 77 78 78 28
28 77 78 77 78 77 78 77 78 78 28

0 11 11 11 11 11 11 11 11 11 0
0 27 27 27 27 27 27 27 27 27 0
0 0 0 0 0 0 0 0 0 0 0
11 0 0 0 0 0 0 0 0 0 11
27 0 0 0 0 0 0 0 0 0 27
0 0 0 0 0 0 0 0 0 0 0
0 0 0 0 0 0 0 0 0 0 0
0 0 0 0 0 0 0 0 0 0 0
0 0 0 0 0 0 0 0 0 0 0
0 0 0 0 0 0 0 0 0 0 0

0 0 0 0 0 9 0 0 0 0 0
0 1586 1587 0 0 25 0 0 0 0 0
0 1594 1595 0 0 0 0 0 0 0 0
0 0 0 0 0 0 0 0 0 0 0
0 0 0 0 0 0 0 0 0 0 0
0 0 0 0 0 0 0 0 0 0 0
0 0 0 0 0 0 0 0 0 0 0
0 0 0 0 0 0 0 0 0 0 0
0 0 0 0 0 0 0 0 0 0 0
0 0 0 0 0 0 0 0 0 0 0

