house2_basement5
8 9
2
1 add_more
513 room-01-udz
4
0 0 0 0 0 0 0 0
0 0 0 0 0 0 0 0
0 0 0 0 0 312 312 312
0 312 312 312 312 312 312 312
0 312 312 312 312 312 312 312
0 312 312 312 312 312 312 312
0 312 312 312 312 312 312 312
312 312 312 312 312 312 312 312
0 312 312 312 312 312 312 312

28 28 28 28 28 519 519 524
28 522 519 519 523 519 519 519
28 519 519 519 531 515 514 515
28 515 514 515 514 515 514 515
28 515 514 515 514 515 514 515
519 515 514 515 514 515 514 515
519 515 514 515 514 515 514 515
514 515 514 515 514 515 514 515
28 515 514 515 514 515 514 515

0 0 0 0 0 521 521 521
0 521 521 521 521 529 529 529
0 529 529 529 529 0 0 0
0 0 0 0 0 0 0 0
0 0 0 0 0 0 0 0
521 0 0 0 0 0 0 0
529 0 0 0 0 0 0 0
0 0 0 0 0 0 0 0
0 0 0 0 0 0 0 0

0 0 0 0 0 0 263 0
0 0 0 0 0 264 279 0
0 0 0 0 0 0 0 0
0 0 0 0 0 0 0 0
0 0 0 0 0 0 0 0
0 0 0 0 0 0 0 0
0 0 0 0 0 0 0 0
0 0 0 0 0 0 0 0
0 0 0 0 0 253 0 0

