house2_basement2
15 7
2
1 add_more
513 room-01-udz
3
519 519 519 519 522 519 519 519 519 28 28 28 28 28 28
530 519 519 519 519 519 519 519 532 519 519 519 519 524 28
513 514 513 514 513 514 513 514 513 531 519 519 519 519 519
513 514 513 514 513 514 513 514 513 514 513 514 513 514 519
513 514 513 514 513 514 513 514 513 514 513 514 513 514 513
28 514 28 28 28 514 513 514 513 514 513 514 513 514 28
28 28 28 28 28 28 28 28 28 28 513 28 28 28 28

521 521 521 521 521 521 521 521 521 0 0 0 0 0 0
529 529 529 529 529 529 529 529 529 521 521 521 521 521 0
0 0 0 0 0 0 0 0 0 529 529 529 529 529 521
0 0 0 0 0 0 0 0 0 0 0 0 0 0 529
0 0 0 0 0 0 0 0 0 0 0 0 0 0 0
0 0 0 0 0 0 0 0 0 0 0 0 0 0 0
0 0 0 0 0 0 0 0 0 0 0 0 0 0 0

0 9 0 0 0 0 0 0 0 0 0 0 0 0 0
0 25 0 0 0 0 0 0 0 0 0 0 0 0 0
0 0 0 0 0 0 0 0 0 0 0 0 0 0 0
0 0 0 0 0 0 0 0 0 0 0 0 0 0 0
0 0 0 0 0 0 0 0 0 0 0 0 0 0 0
0 0 0 0 0 0 0 0 0 0 0 0 0 0 0
0 0 0 0 0 0 0 0 0 0 0 0 0 0 0

