house2_basement4
9 10
2
1 room-01-udz
897 add_more
6
0 0 0 0 0 0 0 0 0
0 0 0 0 0 0 0 0 0
1208 1208 1208 1208 1208 1208 1208 0 0
1208 1208 1208 1208 1208 1208 0 0 0
1208 1208 1208 1208 1208 1208 1208 0 0
1208 1208 1208 1208 1208 1208 1208 0 0
1208 1208 1208 1208 1208 1208 1208 1208 1208
1208 1208 1208 1208 1208 1208 1208 1208 1208
1208 1208 1208 1208 1208 1208 1208 1208 1208
0 0 0 0 1208 0 0 0 0

7 7 11 7 7 10 7 7 7
7 7 19 7 7 7 7 7 7
1 2 1 2 1 2 1 2 1
1 2 1 2 1 2 1 2 1
1 2 1 961 962 962 963 2 1
1 2 1 977 978 978 979 2 1
1 2 1 993 994 994 995 2 1
1 2 1 2 1 2 1 2 1
1 2 1 2 1 2 1 2 1
924 924 924 924 1 924 924 924 924

9 9 9 9 9 9 9 9 9
17 17 17 17 17 17 17 17 17
0 0 0 0 0 0 0 0 0
0 0 0 0 0 0 0 0 0
0 0 0 0 0 0 0 0 0
0 0 0 0 0 0 0 0 0
0 0 0 0 0 0 0 0 0
0 0 0 0 0 0 0 0 0
0 0 0 0 0 0 0 0 0
0 0 0 0 0 0 0 0 0

0 0 0 0 0 0 838 839 840
0 0 0 0 0 0 846 847 848
0 0 0 0 0 0 854 855 856
264 0 0 0 0 0 0 0 0
272 0 0 0 0 0 0 0 0
0 0 0 0 0 0 0 0 0
0 0 0 0 0 0 0 0 0
0 0 0 0 0 0 0 0 0
0 0 0 0 0 0 0 0 0
0 0 0 0 0 0 0 0 0

0 0 0 0 0 0 0 0 0
0 0 0 0 0 0 0 0 0
0 0 0 0 0 0 0 185 186
0 0 0 0 0 0 179 193 194
0 0 0 0 0 0 0 193 194
0 0 0 0 0 0 0 201 202
0 0 0 0 0 0 0 0 0
0 0 0 0 0 0 0 0 0
0 0 0 0 0 0 0 0 0
0 0 0 0 0 0 0 0 0

0 0 0 0 0 0 0 0 0
0 0 0 0 0 0 0 0 0
0 0 0 0 0 0 171 0 0
0 0 0 0 0 0 0 0 0
0 0 0 0 0 0 0 0 0
0 0 0 0 0 0 0 0 0
0 0 0 0 0 0 0 0 0
0 0 0 0 0 0 0 0 0
0 0 0 0 0 0 0 0 0
0 0 0 0 0 0 0 0 0

