house2_basement3
9 9
2
1 room-01-udz
513 add_more
3
10 7 7 7 7 11 7 7 7
18 7 7 7 7 7 7 7 7
1 2 1 2 1 2 1 2 1
1 2 1 2 1 2 1 2 1
1 2 961 962 962 962 963 2 1
1 2 977 978 978 978 979 2 1
1 2 977 978 978 978 979 2 1
1 2 993 994 994 994 995 2 1
1 2 1 2 1 2 1 2 1

9 9 9 9 9 9 9 9 9
17 17 17 17 17 17 17 17 17
0 0 0 0 0 0 0 0 0
0 0 0 0 0 0 0 0 0
0 0 0 0 0 0 0 0 0
0 0 0 0 0 0 0 0 0
0 0 0 0 0 0 0 0 0
0 0 0 0 0 0 0 0 0
0 0 0 0 0 0 0 0 0

0 0 0 0 905 0 0 840 838
0 0 0 0 921 0 0 848 846
0 0 0 0 0 0 0 856 854
0 0 0 0 0 0 0 0 0
0 0 0 0 0 0 0 0 0
0 0 0 0 0 0 0 0 0
0 0 0 0 0 0 0 0 0
0 0 0 0 0 0 0 0 0
0 0 0 0 0 0 0 0 0

