house2_hallway4
12 3
1
1 add_more
3
153 153 153 153 153 153 153 153 153 153 153 153
153 153 153 153 153 153 153 153 153 153 153 153
119 120 119 120 119 120 119 120 119 120 119 120

135 135 135 135 135 135 135 135 135 135 135 135
151 151 151 151 151 151 151 151 151 151 151 151
0 0 0 0 0 0 0 0 0 0 0 0

0 0 9 0 0 0 0 0 0 9 0 0
0 0 25 0 0 0 0 0 0 25 0 0
0 0 0 0 0 0 0 0 0 0 0 0

