house2_room3
9 10
1
1 add_more
5
0 0 0 0 0 0 0 0 0
0 0 0 0 0 0 0 0 0
312 312 312 312 312 312 312 312 0
312 312 312 312 312 312 312 312 0
312 312 312 312 312 312 312 312 312
0 0 312 312 312 312 312 312 0
0 0 312 312 312 312 312 312 0
0 0 312 312 312 312 312 312 0
0 312 312 312 312 312 312 312 0
312 312 312 312 312 312 312 312 0

170 170 170 170 170 170 170 170 28
170 170 170 170 170 170 170 170 28
185 186 185 172 185 186 185 186 170
185 186 173 186 185 186 188 186 170
185 186 185 189 185 186 185 186 185
185 186 185 186 185 186 185 186 28
185 186 185 186 185 186 185 186 28
185 186 185 186 185 186 185 186 28
190 186 185 186 185 186 185 186 28
185 186 185 186 185 186 185 174 28

171 171 171 171 171 171 171 171 0
187 187 187 187 187 187 187 187 0
0 0 0 0 0 0 0 0 171
0 0 0 0 0 0 0 0 187
0 0 0 0 0 0 0 0 0
0 0 0 0 0 0 0 0 0
0 0 0 0 0 0 0 0 0
0 0 0 0 0 0 0 0 0
0 0 0 0 0 0 0 0 0
0 0 0 0 0 0 0 0 0

0 0 217 0 0 0 0 0 0
0 0 233 0 0 0 0 0 0
0 0 249 0 0 0 0 0 0
0 0 0 0 0 0 0 0 0
0 0 0 0 0 0 0 0 0
202 203 0 0 0 0 0 0 0
204 205 0 0 0 0 0 0 0
206 207 0 0 0 0 0 0 0
0 0 0 0 0 0 0 0 0
0 0 0 0 0 0 0 0 0

0 0 0 0 0 0 0 0 0
0 0 0 0 0 0 0 0 0
0 0 0 0 0 0 0 0 0
0 0 0 0 0 0 0 0 0
200 201 0 0 0 0 0 0 0
0 0 0 0 0 0 0 0 0
0 0 0 0 0 0 0 0 0
0 0 0 0 0 0 0 0 0
0 0 0 0 0 0 0 0 0
0 0 0 0 0 0 0 0 0

