house2_room2
8 13
2
1 add_more
513 room-01-udy
4
28 153 153 153 153 153 153 153
28 153 153 153 153 153 153 153
153 119 120 119 120 106 120 141
153 119 120 119 120 119 120 119
120 119 169 119 120 119 120 119
28 119 120 119 120 119 120 138
28 119 120 119 120 119 120 119
28 119 120 119 120 119 120 119
28 119 120 119 120 119 121 119
28 119 120 119 120 119 120 119
28 119 137 119 120 119 120 119
28 119 120 119 120 119 120 119
28 119 120 119 120 119 120 119

0 135 135 135 135 135 135 135
0 151 151 151 151 151 151 151
135 0 0 0 0 0 0 0
151 0 0 0 0 0 0 0
0 0 0 0 0 0 0 0
0 0 0 0 0 0 0 0
0 0 0 0 0 0 0 0
0 0 0 0 0 0 0 0
0 0 0 0 0 0 0 0
0 0 0 0 0 0 0 0
0 0 0 0 0 0 0 0
0 0 0 0 0 0 0 0
0 0 0 0 0 0 0 0

0 0 0 0 0 0 0 0
0 875 0 685 686 687 0 0
0 883 0 693 694 695 0 0
0 0 0 0 0 0 0 0
0 0 0 220 221 222 0 0
0 0 889 236 237 238 890 0
0 0 897 236 237 238 898 0
0 0 0 236 237 238 0 0
0 0 889 236 237 238 890 0
0 0 897 236 237 238 898 0
0 0 0 236 237 238 0 0
0 0 889 236 237 238 890 0
0 0 897 236 237 238 898 0

0 0 0 0 0 0 0 0
0 0 0 0 0 0 0 0
0 0 0 0 0 0 0 0
0 0 0 0 0 0 0 0
0 0 0 0 0 0 0 0
0 0 0 0 0 0 0 0
0 0 0 905 0 0 0 0
0 0 0 0 0 0 0 0
0 0 0 0 0 0 0 0
0 0 0 906 0 0 0 0
0 0 0 0 0 906 0 0
0 0 0 0 0 0 0 0
0 0 0 0 0 0 0 0

