house2_hallway2
9 13
1
1 add_more
5
0 0 0 0 0 0 0 0 0
0 0 0 0 0 0 0 0 0
0 312 312 312 312 312 312 312 0
0 312 312 312 312 312 312 312 0
0 312 312 0 0 0 312 312 0
0 312 312 0 0 0 312 312 0
0 0 0 0 0 0 312 312 0
0 0 0 0 0 0 312 312 0
0 0 0 0 0 0 312 312 0
0 0 0 0 0 0 312 312 0
0 0 0 0 312 312 312 312 0
0 0 0 0 312 312 312 312 0
0 0 0 0 312 312 312 312 0

28 153 153 153 153 153 153 153 28
153 153 153 153 153 153 153 153 153
153 122 120 119 120 119 120 141 153
120 119 120 106 120 119 120 119 120
28 119 120 28 28 28 120 119 28
28 28 28 28 28 28 142 119 28
28 28 28 28 28 28 120 119 28
28 28 28 28 28 28 120 119 28
28 28 28 28 28 28 120 137 28
28 28 28 28 28 28 120 119 28
28 28 28 28 120 119 120 119 28
28 28 28 28 120 119 120 119 28
28 28 28 28 154 119 120 157 28

0 135 135 135 135 135 135 135 0
135 151 151 151 151 151 151 151 135
151 0 0 0 0 0 0 0 151
0 0 0 0 0 0 0 0 0
0 0 0 0 0 0 0 0 0
0 0 0 0 0 0 0 0 0
0 0 0 0 0 0 0 0 0
0 0 0 0 0 0 0 0 0
0 0 0 0 0 0 0 0 0
0 0 0 0 0 0 0 0 0
0 0 0 0 0 0 0 0 0
0 0 0 0 0 0 0 0 0
0 0 0 0 0 0 0 0 0

0 0 139 140 0 139 140 0 0
0 0 155 156 0 155 156 0 0
0 0 0 0 0 0 0 0 0
0 0 0 0 0 0 0 0 0
0 0 0 0 0 0 0 0 0
0 136 136 0 0 0 0 0 0
0 136 136 0 136 136 0 0 0
0 136 136 0 136 136 0 0 0
0 136 136 0 136 136 0 0 0
0 152 152 0 136 136 0 0 0
0 0 0 0 152 152 0 0 0
0 0 0 0 0 0 0 0 0
0 0 0 0 0 0 0 0 0

0 0 0 0 0 0 0 0 0
0 0 0 0 0 0 0 0 0
0 0 0 0 0 0 0 0 0
0 0 0 0 0 0 0 0 0
0 0 0 0 0 0 0 0 0
0 0 0 0 0 0 0 0 0
0 0 0 0 0 143 0 0 0
0 0 0 0 0 143 0 0 0
0 0 0 0 0 143 0 0 0
0 0 0 0 0 143 0 0 0
0 0 0 0 0 159 0 0 0
0 0 0 0 0 0 0 0 0
0 0 0 0 0 0 0 0 0

