house2_basement9
11 17
2
1 add_more
513 room-01-udz
5
0 0 0 0 0 0 0 0 0 0 0
0 0 0 0 0 0 0 0 0 0 0
0 0 312 312 312 312 312 312 312 312 312
312 312 312 312 312 312 312 312 312 312 312
312 312 312 312 312 312 312 312 312 312 312
312 312 312 312 312 312 312 312 312 312 312
312 312 312 312 312 312 312 312 312 312 312
312 312 312 312 312 312 312 312 312 312 312
312 312 312 312 312 312 312 312 312 0 312
0 0 312 312 312 312 312 312 312 312 312
0 0 312 312 312 312 312 312 312 312 312
0 0 0 0 312 312 0 0 0 0 0
0 0 0 0 312 312 0 0 0 0 0
0 0 0 0 312 312 312 0 0 0 0
0 0 0 0 312 312 312 0 0 0 0
0 0 0 0 312 312 312 0 0 0 0
0 0 0 0 312 312 0 0 0 0 0

522 519 519 523 519 519 519 519 519 519 524
519 519 519 519 519 519 531 519 519 519 532
513 514 513 514 513 514 513 514 513 514 513
513 514 513 514 513 514 513 514 513 514 513
513 514 513 514 513 514 513 514 513 514 513
513 514 513 514 513 514 513 514 513 514 513
513 514 513 514 513 514 513 514 513 514 513
513 514 513 514 513 514 513 514 513 514 513
513 514 513 514 513 514 513 514 513 514 513
513 514 513 514 513 514 513 514 513 514 513
513 514 513 514 513 514 513 514 513 514 513
28 28 28 28 513 514 513 28 28 28 28
28 28 28 28 513 514 513 28 28 28 28
28 28 28 28 513 514 513 28 28 28 28
28 28 28 28 513 514 513 28 28 28 28
28 28 28 28 513 514 513 28 28 28 28
28 28 28 28 513 514 513 28 28 28 28

521 521 521 521 521 521 521 521 521 521 521
529 529 529 529 529 529 529 529 529 529 529
0 0 0 0 0 0 0 0 0 0 0
0 0 0 0 0 0 0 0 0 0 0
0 0 0 0 0 0 0 0 0 0 0
0 0 0 0 0 0 0 0 0 0 0
0 0 0 0 0 0 0 0 0 0 0
0 0 0 0 0 0 0 0 0 0 0
0 0 0 0 0 0 0 0 0 0 0
0 0 0 0 0 0 0 0 0 0 0
0 0 0 0 0 0 0 0 0 0 0
0 0 0 0 0 0 0 0 0 0 0
0 0 0 0 0 0 0 0 0 0 0
0 0 0 0 0 0 0 0 0 0 0
0 0 0 0 0 0 0 0 0 0 0
0 0 0 0 0 0 0 0 0 0 0
0 0 0 0 0 0 0 0 0 0 0

0 0 0 266 0 0 0 267 0 0 0
1114 1115 0 282 0 280 0 283 0 0 0
1122 1123 0 0 0 0 0 0 0 0 0
0 0 0 0 0 0 0 0 0 0 0
0 0 0 0 0 0 0 0 0 0 0
0 0 0 0 0 0 0 0 0 0 0
0 0 0 0 0 0 0 0 0 0 0
0 0 0 0 0 0 0 0 979 0 981
0 0 0 0 0 0 0 0 987 988 989
635 636 0 0 0 0 0 0 0 0 0
625 626 0 0 0 0 0 0 0 0 0
0 0 0 0 0 0 613 0 0 0 0
0 0 0 0 0 0 621 0 0 0 0
0 0 0 0 0 0 0 0 0 0 0
0 0 0 0 0 0 0 0 0 0 0
0 0 0 0 0 0 0 0 0 0 0
0 0 0 0 0 0 767 0 0 0 0

0 0 0 0 0 0 0 0 0 0 0
0 0 0 0 0 0 0 0 0 0 0
0 0 0 0 0 0 0 0 0 0 0
0 0 0 0 0 0 0 0 0 0 0
0 0 0 0 0 0 0 0 0 0 0
0 0 0 0 0 0 0 0 0 0 0
0 0 0 0 0 0 0 0 0 0 0
0 0 0 0 0 0 0 0 0 980 0
627 628 0 0 0 0 0 0 0 0 0
0 0 0 0 0 0 0 0 0 0 0
0 0 0 0 0 0 0 0 0 0 0
0 0 0 0 0 0 0 0 0 0 0
0 0 0 0 0 0 0 0 0 0 0
0 0 0 0 0 0 0 0 0 0 0
0 0 0 0 0 0 0 0 0 0 0
0 0 0 0 0 0 0 0 0 0 0
0 0 0 0 0 0 0 0 0 0 0

