house2_hallway1
14 6
1
1 add_more
4
0 0 0 0 0 0 0 0 0 0 0 0 0 0
0 0 0 0 0 0 0 0 0 0 0 0 0 0
312 312 312 312 312 312 312 312 312 312 312 312 312 312
312 312 312 312 312 312 312 312 312 312 312 312 312 312
0 0 0 0 0 0 0 312 312 312 0 0 0 0
0 0 0 0 0 0 0 0 0 0 0 0 0 0

153 153 153 153 153 153 153 153 153 153 153 153 153 153
153 153 153 153 153 153 153 153 153 153 153 153 153 153
137 120 119 120 119 120 119 120 119 120 119 120 119 120
119 120 119 120 119 106 119 120 119 120 119 122 119 120
28 120 28 28 28 28 28 120 119 120 28 28 119 28
28 28 28 28 28 28 28 120 120 119 28 28 28 28

135 135 135 135 135 135 135 135 135 135 135 135 135 135
151 151 151 151 151 151 151 151 151 151 151 151 151 151
0 0 0 0 0 0 0 0 0 0 0 0 0 0
0 0 0 0 0 0 0 0 0 0 0 0 0 0
0 0 0 0 0 0 0 0 0 0 0 0 0 0
0 0 0 0 0 0 0 0 0 0 0 0 0 0

0 0 0 0 139 140 0 0 139 140 0 0 0 0
0 0 0 0 155 156 0 0 155 156 0 0 0 0
0 0 0 0 0 0 0 0 0 0 0 0 0 0
0 0 0 0 0 0 0 0 0 0 0 0 0 0
0 0 0 0 0 0 0 0 0 0 0 0 0 0
0 0 0 0 0 0 0 0 0 0 0 0 0 0

