house2_basement8
10 8
2
1 room-01-udz
513 add_more
3
7 7 7 7 11 7 7 7 12 924
7 7 7 7 7 7 7 7 7 924
1 2 1 2 1 2 1 2 1 924
1 2 961 962 962 962 963 2 1 7
1 2 977 978 978 978 979 2 1 7
1 2 977 978 978 978 979 2 1 2
1 2 993 994 994 994 995 2 1 924
1 2 1 2 1 2 1 2 1 924

9 9 9 9 9 9 9 9 9 0
17 17 17 17 17 17 17 17 17 0
0 0 0 0 0 0 0 0 0 0
0 0 0 0 0 0 0 0 0 9
0 0 0 0 0 0 0 0 0 17
0 0 0 0 0 0 0 0 0 0
0 0 0 0 0 0 0 0 0 0
0 0 0 0 0 0 0 0 0 0

0 0 0 0 0 0 0 0 0 0
0 0 0 0 0 0 0 0 884 0
0 0 0 0 0 0 0 0 892 0
0 0 0 0 0 0 0 0 0 0
0 0 0 0 0 0 0 0 0 0
0 0 0 0 0 0 0 0 0 0
0 0 0 0 0 0 0 0 0 0
0 0 0 0 0 0 0 0 0 0

