house3_basement3 48
15 11
5
1 room-01-udw
1113 add_more
1625 room-01-udy
2041 room-01-udz
2937 room-01-ud
3
0 0 0 0 0 0 0 0 0 0 0 0 0 0 0
0 0 0 0 0 0 0 0 0 0 0 0 0 0 0
1424 0 1424 1424 0 1424 1424 0 1424 1424 0 1424 1424 1424 1424
1424 0 1424 1424 0 1424 1424 0 1424 1424 0 1424 1424 1424 1424
1424 1424 1424 1424 1424 1424 1424 1424 1424 1424 1424 1424 1424 1424 1424
1424 1424 1424 1424 1424 1424 1424 1424 1424 1424 1424 1424 1424 1424 1424
1424 1424 1424 1424 1424 1424 1424 1424 1424 1424 1424 1424 1424 1424 1424
1424 1424 1424 1424 1424 1424 1424 1424 1424 1424 1424 1424 1424 1424 1424
1424 1424 1424 1424 1424 1424 1424 1424 1424 1424 1424 1424 1424 1424 1424
1424 1424 1424 1424 1424 1424 1424 1424 1424 1424 1424 1424 1424 1424 1424
0 0 0 0 0 0 0 1424 0 0 0 0 0 0 0

812 812 812 812 812 812 812 812 812 812 812 812 812 812 812
820 820 820 820 820 820 820 820 820 820 820 820 820 820 820
1 2 3 4 1 2 3 4 1 2 3 4 1 2 3
1 2 3 4 1 2 3 4 1 2 3 4 1 2 3
1 2 3 4 1 2 3 4 1 2 3 4 1 2 3
1 2 3 4 1 2 3 4 1 2 3 4 1 2 3
1 2 3 4 1 2 3 4 1 2 3 4 1 2 3
1 2 3 4 1 2 3 4 1 2 3 4 1 2 3
1 2 3 4 1 2 3 4 1 2 3 4 1 2 3
1 2 3 4 1 2 3 4 1 2 3 4 1 2 3
0 0 0 0 0 0 0 1 0 0 0 0 0 0 0

0 0 0 0 0 0 0 0 0 0 0 0 0 0 0
0 2120 0 0 2120 0 0 2120 0 0 2120 0 0 0 0
0 2128 0 0 2128 0 0 2128 0 0 2128 0 0 0 0
0 2136 0 0 2136 0 0 2136 0 0 2136 0 0 0 0
0 0 0 0 0 0 0 0 0 0 0 0 0 0 0
0 0 0 0 0 0 0 0 0 0 0 0 0 0 0
0 0 0 0 0 0 0 0 0 0 0 0 0 0 0
0 0 0 0 0 0 0 0 0 0 0 0 0 0 0
0 0 0 0 0 0 0 0 0 0 0 0 0 0 0
0 0 0 0 0 0 0 0 0 0 0 0 0 0 0
0 0 0 0 0 0 0 0 0 0 0 0 0 0 0

