house3_hallway3
16 14
2
1 room-01-udw
1113 add_more
2
1057 1058 1059 1060 1061 0 0 0 0 0 0 0 0 0 0 0
1065 1066 1067 1068 1069 0 0 0 0 0 0 0 0 0 0 0
1 1 2 3 4 1057 0 0 0 0 0 0 0 0 0 0
1 1 2 3 4 1065 0 0 0 0 0 0 0 0 0 0
1 1 1 2 3 4 0 0 0 0 0 0 0 0 0 0
0 0 1 2 3 0 0 0 0 0 0 0 0 0 0 0
0 0 1 2 3 0 0 0 0 0 0 0 0 0 0 0
0 0 1 2 3 0 0 0 0 0 0 0 0 0 0 0
0 0 1 2 3 0 0 0 0 0 0 0 0 0 0 0
0 0 1 2 3 1033 1034 1035 1036 1037 1038 1039 1040 1033 1034 1035
1042 1043 1 2 3 1041 1042 1043 1044 1045 1046 1047 1048 1041 1042 1043
1 2 3 4 3 1 2 3 4 1 2 3 4 1 2 3
1 2 3 4 3 1 2 3 4 1 2 3 4 1 2 3
1 2 3 4 3 1 2 3 4 1 2 3 4 1 2 3

0 0 0 0 0 0 0 0 0 0 0 0 0 0 0 0
0 0 0 0 0 0 0 0 0 0 0 0 0 0 0 0
0 0 0 0 0 0 0 0 0 0 0 0 0 0 0 0
0 0 0 0 0 0 0 0 0 0 0 0 0 0 0 0
0 0 0 0 0 0 0 0 0 0 0 0 0 0 0 0
57 57 0 0 0 0 0 0 0 0 0 0 0 0 0 0
57 57 0 0 0 0 0 0 0 0 0 0 0 0 0 0
57 57 0 0 0 0 0 0 0 0 0 0 0 0 0 0
57 57 0 0 0 0 0 0 0 0 0 0 0 0 0 0
57 57 0 0 0 0 0 1121 0 0 0 0 0 1121 0 0
65 65 0 0 0 0 0 1137 0 0 0 0 0 1137 0 0
0 0 0 0 0 0 0 0 0 0 0 0 0 0 0 0
0 0 0 0 0 0 0 0 0 0 0 0 0 0 0 0
0 0 0 0 0 0 0 0 0 0 0 0 0 0 0 0

