house3_hallway2
9 15
1
1 room-01-udw
2
0 1082 1083 1084 1085 1086 1083 1082 0
0 1090 1091 1092 1093 1094 1091 1090 0
0 1098 1099 1100 1101 1102 1099 1098 0
265 266 267 268 269 265 266 267 268
273 274 275 276 277 273 274 275 276
281 282 283 284 285 281 282 283 284
289 290 291 292 293 289 290 291 292
297 298 299 347 298 298 298 298 300
275 276 277 298 298 298 275 276 277
299 298 298 298 298 298 298 298 298
275 276 277 298 298 298 275 276 277
299 298 298 298 298 298 298 298 299
275 276 277 298 298 298 275 276 277
299 298 298 298 298 298 298 298 299
0 0 0 0 298 0 0 0 0

1081 0 0 0 0 0 0 0 1088
1089 0 0 0 0 0 0 0 1096
1097 0 0 0 0 0 0 0 1104
1105 0 0 0 0 0 0 0 1112
0 0 920 0 0 0 920 0 0
0 0 928 0 0 0 928 0 0
0 0 0 0 0 0 0 0 0
0 0 0 0 0 0 0 0 0
905 906 907 0 0 0 905 906 907
0 0 0 0 0 0 0 0 0
913 914 915 0 0 0 913 914 915
0 0 0 0 0 0 0 0 0
921 922 923 0 0 0 921 922 923
0 0 0 0 0 0 0 0 0
0 0 0 0 0 0 0 0 0

