house2_room7 43
8 10
1
1 add_more
4
0 0 0 0 0 0 0 0
0 0 0 0 0 0 0 0
312 312 312 312 312 312 312 0
312 312 312 312 312 312 312 0
312 312 312 312 312 312 312 0
312 312 312 312 312 312 312 0
312 312 312 0 312 312 312 0
312 312 312 312 312 312 312 312
312 312 312 312 312 312 312 0
312 312 312 312 312 312 312 0

153 153 153 153 153 153 153 28
153 153 153 153 153 153 153 28
120 119 120 119 120 119 120 28
120 119 120 119 120 119 120 28
120 119 137 138 120 119 120 28
120 119 120 119 120 252 120 153
120 119 120 119 120 119 120 153
121 119 120 119 120 119 120 119
120 119 120 119 120 119 120 28
106 119 120 119 120 119 120 28

135 135 135 135 135 135 135 0
151 151 151 151 151 151 151 0
0 0 0 0 0 0 0 0
0 0 0 0 0 0 0 0
0 0 0 0 0 0 0 0
0 0 0 0 0 0 0 135
0 0 0 0 0 0 0 151
0 0 0 0 0 0 0 0
0 0 0 0 0 0 0 0
0 0 0 0 0 0 0 0

0 272 0 0 0 0 271 0
0 288 0 0 0 0 287 0
0 304 0 0 0 0 303 0
0 0 0 0 0 0 0 0
0 0 0 0 0 0 0 0
0 0 0 254 0 0 0 0
0 0 0 255 0 0 0 0
0 0 0 0 0 0 0 0
0 0 0 0 0 0 0 0
0 0 0 0 0 0 0 0

