house2_underpass2
11 13
1
1 add_more
3
0 0 0 0 0 0 0 0 0 0 0
0 0 0 0 0 0 0 0 0 0 0
0 0 0 0 0 0 0 0 0 0 0
0 0 0 0 0 0 0 0 0 0 0
0 0 0 0 0 0 0 0 0 0 0
0 0 0 0 0 0 0 0 0 0 0
0 0 0 0 0 0 0 312 312 312 0
0 0 0 0 0 0 0 312 312 312 0
0 0 0 0 0 0 0 312 312 312 0
0 0 0 0 0 0 0 312 312 312 0
0 312 312 312 312 312 312 312 312 312 0
0 312 312 312 312 312 312 312 312 312 0
0 0 0 0 0 0 0 0 0 0 0

28 28 28 28 28 28 28 306 285 285 28
28 28 28 28 28 28 28 306 301 301 28
28 28 28 28 28 28 28 306 285 285 28
28 28 28 28 28 28 28 306 301 301 28
28 28 28 28 28 28 28 306 285 285 28
28 28 28 28 28 28 28 306 301 301 28
28 28 28 28 28 28 28 322 299 300 28
28 28 28 28 28 28 28 338 299 300 28
310 310 310 310 310 310 309 298 299 300 28
326 326 326 326 326 326 325 298 299 300 28
298 299 298 299 298 299 298 298 299 300 28
298 299 298 299 298 299 298 298 299 300 28
28 28 28 28 28 28 28 28 28 28 28

0 0 0 0 0 0 305 0 0 0 308
0 0 0 0 0 0 305 0 0 0 308
0 0 0 0 0 0 305 0 0 0 308
0 0 0 0 0 0 305 0 0 0 308
0 0 0 0 0 0 305 0 0 0 308
0 0 0 0 0 0 305 0 0 0 308
0 0 0 0 0 0 321 0 0 0 308
270 270 270 270 270 270 337 0 0 0 308
0 0 0 0 0 0 0 0 0 0 308
0 0 0 0 0 0 0 0 0 0 308
0 0 0 0 0 0 0 0 0 0 308
0 0 0 0 0 0 0 0 0 0 324
339 339 339 339 339 339 339 339 339 339 340

