house3_hallway1
20 17
2
1 room-01-udw
1113 add_more
2
0 0 1033 1034 1035 0 0 0 0 0 0 0 0 0 0 0 0 0 0 0
0 0 1041 1121 1043 0 0 0 0 0 0 0 0 0 0 0 0 0 0 0
0 0 1049 1137 1051 0 0 0 0 0 0 0 0 0 0 0 0 0 0 0
0 0 1 2 3 0 0 0 0 0 0 0 0 0 0 0 0 0 0 0
0 0 1 2 3 0 0 0 0 0 0 0 0 0 0 0 0 0 0 0
0 0 1 2 3 0 0 0 0 0 0 0 0 0 0 0 0 0 0 0
0 0 1 2 3 0 0 0 0 0 0 0 0 0 0 0 0 0 0 0
0 0 1 2 3 0 0 0 0 0 0 0 0 0 0 0 0 0 0 0
57 57 1 2 3 0 0 0 0 0 0 0 0 0 0 0 0 0 0 0
57 57 1 2 3 0 0 0 0 0 0 0 0 0 0 0 0 0 0 0
57 57 1 2 3 0 0 0 0 0 0 0 0 0 0 0 0 0 0 0
57 57 1 2 3 1033 1034 1035 1036 1037 1038 1039 1040 1057 1058 1059 1060 1061 1062 1063
57 57 1 2 3 1041 1042 1043 1044 1045 1046 1047 1048 1065 1066 1067 1068 1069 1070 1071
57 57 1 2 3 1049 1050 1051 1052 1053 1054 1055 1056 1073 1074 1075 1076 1077 1078 1079
1 2 3 4 3 1 2 3 4 1 2 3 4 1 2 3 4 1 2 3
1 2 3 4 3 1 2 3 4 1 2 3 4 1 2 3 4 1 2 3
1 2 3 4 3 1 2 3 4 1 2 3 4 1 2 3 4 1 2 3

0 0 0 0 0 0 0 0 0 0 0 0 0 0 0 0 0 0 0 0
0 0 0 0 0 0 0 0 0 0 0 0 0 0 0 0 0 0 0 0
0 0 0 0 0 0 0 0 0 0 0 0 0 0 0 0 0 0 0 0
0 0 0 0 0 1033 0 0 0 0 0 0 0 0 0 0 0 0 0 0
0 0 0 0 0 1041 0 0 0 0 0 0 0 0 0 0 0 0 0 0
0 0 0 0 0 1049 0 0 0 0 0 0 0 0 0 0 0 0 0 0
0 0 1 2 3 4 0 0 0 0 0 0 0 0 0 0 0 0 0 0
0 0 0 0 0 0 0 0 0 0 0 0 0 0 0 0 0 0 0 0
0 0 0 0 0 0 0 0 0 0 0 0 0 0 0 0 0 0 0 0
0 0 0 0 0 0 0 0 0 0 0 0 0 0 0 0 0 0 0 0
0 0 0 0 0 0 0 0 0 0 0 0 0 0 0 0 0 0 0 0
0 0 0 0 0 0 0 0 0 0 0 0 0 0 0 0 0 0 0 0
0 0 0 0 0 0 1121 0 0 0 0 0 0 1121 0 0 0 0 0 0
0 0 0 0 0 0 1137 0 0 0 0 0 0 1137 0 0 0 0 0 0
0 0 0 0 0 0 0 0 0 0 0 0 0 0 0 0 0 0 0 0
0 0 0 0 0 0 0 0 0 0 0 0 0 0 0 0 0 0 0 0
0 0 0 0 0 0 0 0 0 0 0 0 0 0 0 0 0 0 0 0

