house2_underpass1
11 13
1
1 add_more
4
0 0 0 0 0 0 0 0 0 0 0
0 0 0 0 0 0 0 0 0 0 0
0 0 0 0 0 0 0 0 0 0 0
0 312 312 312 0 0 0 0 0 0 0
0 312 312 312 0 0 0 0 0 0 0
0 312 312 312 0 0 0 0 0 0 0
0 312 312 312 0 0 0 0 0 0 0
0 312 312 312 0 0 0 0 0 0 0
0 312 312 312 0 0 0 0 0 0 0
0 312 312 312 0 0 0 0 0 0 0
0 312 312 312 312 312 312 312 312 312 312
0 312 312 312 312 312 312 312 312 312 312
0 0 0 0 0 0 0 0 0 0 0

28 28 28 28 28 28 28 28 28 28 28
28 285 285 285 28 28 28 28 28 28 28
28 301 301 301 28 28 28 28 28 28 28
28 298 299 300 28 28 28 28 28 28 28
28 298 299 300 28 28 28 28 28 28 28
28 298 299 300 28 28 28 28 28 28 28
28 298 299 300 28 28 28 28 28 28 28
28 298 299 300 28 28 28 28 28 28 28
28 298 299 300 293 285 285 285 285 285 285
28 298 299 298 292 301 301 301 301 301 301
28 298 299 298 299 298 299 298 299 298 299
28 298 299 298 299 298 299 298 299 298 299
28 28 28 28 28 28 28 28 28 28 28

269 270 270 270 286 0 0 0 0 0 0
297 0 0 0 302 0 0 0 0 0 0
297 0 0 0 302 0 0 0 0 0 0
297 0 0 0 302 0 0 0 0 0 0
297 0 0 0 302 0 0 0 0 0 0
297 0 0 0 302 0 0 0 0 0 0
297 0 0 0 302 0 0 0 0 0 0
297 0 0 0 294 270 270 270 270 270 270
297 0 0 0 0 0 0 0 0 0 0
297 0 0 0 0 0 0 0 0 0 0
297 0 0 0 0 0 0 0 0 0 0
297 0 0 0 0 0 0 0 0 0 0
295 296 296 296 296 296 296 296 296 296 296

0 0 0 0 0 0 0 0 0 0 0
0 0 268 0 0 0 0 0 0 0 0
0 0 284 0 0 0 0 0 0 0 0
0 0 0 0 0 0 0 0 0 0 0
0 0 0 0 0 0 0 0 0 0 0
0 0 0 0 0 0 0 0 0 0 0
0 0 0 0 0 0 0 0 0 0 0
0 0 0 0 0 0 0 0 0 0 0
0 0 0 0 0 0 0 0 0 0 0
0 0 0 0 0 0 0 0 0 0 0
0 0 0 0 0 0 0 0 0 0 0
0 0 0 0 0 0 0 0 0 0 0
0 0 0 0 0 0 0 0 0 0 0

