house3_basement1 46
9 11
5
1 room-01-udw
1113 add_more
1625 room-01-udy
2041 room-01-udz
2937 room-01-ud
3
0 0 0 0 0 0 0 0 0
0 0 0 0 0 0 0 0 0
1424 1424 1424 1424 0 1424 1424 1424 1424
1424 1424 1424 1424 1424 1424 1424 1424 1424
1424 1424 1424 1424 1424 1424 1424 1424 1424
1424 1424 1424 1424 1424 1424 1424 1424 1424
1424 1424 1424 1424 1424 1424 1424 1424 1424
1424 1424 1424 1424 1424 1424 1424 1424 1424
1424 1424 1424 1424 1424 1424 1424 1424 1424
1424 1424 1424 1424 1424 1424 1424 1424 1424
0 0 0 0 1424 0 0 0 0

812 812 812 812 812 812 812 812 812
820 820 820 820 820 820 820 820 820
1 2 3 1 2 3 4 3 4
1 2 3 1 2 3 4 3 4
1 2 3 1 2 3 4 3 4
1 2 3 1 2 3 4 3 4
1 2 3 1 2 3 4 3 4
1 2 1 2 3 4 4 3 4
1 2 1 2 3 4 2 3 4
1 2 3 4 1 1 2 3 4
0 0 0 0 2 0 0 0 0

0 1010 1011 0 1012 0 0 1013 0
0 0 0 0 0 0 0 0 0
0 0 0 0 2296 0 0 0 0
0 0 0 0 0 0 0 0 0
0 0 0 0 0 0 0 0 0
0 0 0 0 0 0 0 0 0
0 0 0 0 0 0 0 0 0
0 0 0 0 0 0 0 0 0
0 0 0 0 0 0 0 0 0
0 0 0 0 0 0 0 0 0
0 0 0 0 0 0 0 0 0

