house3_basement2 47
18 7
5
1 room-01-udw
1113 add_more
1625 room-01-udy
2041 room-01-udz
2937 room-01-ud
3
0 0 0 0 0 0 0 0 0 0 0 0 0 0 0 0 0 0
0 0 0 0 0 0 0 0 0 0 0 0 0 0 0 0 0 0
0 0 0 0 0 0 0 0 1424 1424 1424 1424 1424 1424 1424 1424 1424 0
1424 1424 1424 1424 1424 1424 1424 1424 1424 1424 1424 1424 1424 1424 1424 1424 1424 1424
1424 1424 1424 1424 1424 1424 1424 1424 1424 1424 1424 1424 1424 1424 1424 1424 1424 0
1424 1424 1424 1424 1424 1424 1424 1424 0 0 0 0 0 0 1424 0 0 0
0 0 0 0 0 0 1424 0 0 0 0 0 0 0 0 0 0 0

0 0 0 0 0 0 0 0 1086 1086 1086 1086 1086 1086 1086 1086 1086 0
1086 1086 1086 1086 1086 1086 1086 1086 1094 1094 1094 1094 1094 1094 1094 1094 1094 1086
1094 1094 1094 1094 1094 1094 1094 1094 269 269 269 269 269 269 269 269 269 1094
269 269 269 269 269 269 269 269 269 269 269 269 269 269 269 269 269 269
269 269 269 269 269 269 269 269 269 269 269 269 269 269 269 269 269 0
269 269 269 269 269 269 269 269 0 0 0 0 0 0 269 0 0 0
0 0 0 0 0 0 269 0 0 0 0 0 0 0 0 0 0 0

0 0 0 0 0 0 0 0 0 0 0 0 1431 0 0 0 0 0
0 0 0 1431 0 0 0 0 0 0 0 0 1447 0 0 0 0 0
0 0 0 1447 0 0 0 0 0 0 0 0 0 0 0 0 0 0
0 0 0 0 0 0 0 0 0 0 0 0 0 0 0 0 0 0
0 0 0 0 0 0 0 0 0 0 0 0 0 0 0 0 0 0
0 0 0 0 0 0 0 0 0 0 0 0 0 0 0 0 0 0
0 0 0 0 0 0 0 0 0 0 0 0 0 0 0 0 0 0

