house3_basement4 49
15 13
5
1 room-01-udw
1113 add_more
1625 room-01-udy
2041 room-01-udz
2937 room-01-ud
3
0 0 0 0 0 0 0 0 0 0 0 0 0 0 0
0 0 0 0 0 0 0 0 0 0 0 0 0 0 0
0 0 0 0 0 0 0 0 0 0 0 0 1424 1424 1424
0 0 0 0 0 0 0 0 0 0 0 0 1424 1424 1424
0 0 0 0 0 0 0 0 0 0 0 0 1424 1424 1424
0 0 0 0 0 0 0 0 0 0 0 0 1424 1424 1424
0 0 0 0 0 0 0 0 0 0 0 0 1424 1424 1424
0 0 0 0 0 0 0 0 0 0 2138 0 1424 1424 1424
0 0 0 0 0 0 0 0 0 0 2146 0 1424 1424 1424
1424 1424 1424 1424 1424 0 1424 1424 1424 1424 1424 1424 1424 1424 1424
1424 1424 1424 1424 1424 1424 1424 1424 1424 1424 1424 1424 1424 1424 1424
1424 1424 1424 1424 1424 1424 1424 1424 1424 1424 1424 1424 1424 1424 1424
0 1424 0 0 0 0 0 0 0 0 0 0 0 0 0

1083 1083 1083 1083 1083 1670 1083 1083 1083 1083 1083 1670 1083 1431 1083
1091 1091 1091 1091 1091 1670 1091 1091 1091 1091 1091 1670 1091 1447 1091
313 313 313 313 313 1670 313 313 313 313 313 1670 313 313 313
313 313 313 313 313 1670 313 313 313 313 313 1670 313 313 313
313 313 313 313 313 1670 313 313 313 313 313 1670 313 313 313
313 313 313 313 313 1670 313 313 313 313 313 1670 313 313 313
313 313 313 313 313 1670 313 313 313 313 313 1670 313 313 313
313 313 313 313 313 1083 313 313 313 313 313 1083 313 313 313
313 313 313 313 313 1091 313 313 313 313 313 1091 313 313 313
313 313 313 313 313 313 313 313 313 313 313 313 313 313 313
313 313 313 313 313 313 313 313 313 313 313 313 313 313 313
313 313 313 313 313 313 313 313 313 313 313 313 313 313 313
0 313 0 0 0 0 0 0 0 0 0 0 0 0 0

0 0 0 0 0 0 0 0 0 0 0 0 0 0 0
0 0 0 0 0 0 0 0 0 0 0 0 0 0 0
0 0 0 0 0 0 0 0 0 0 0 0 0 0 0
0 0 0 0 0 0 0 0 0 0 0 0 0 0 0
0 0 0 0 0 0 0 0 0 0 0 0 0 0 0
0 0 0 0 0 0 0 0 0 0 0 0 0 0 0
0 0 0 0 0 0 0 0 0 0 0 0 0 0 0
2139 2141 2137 2138 2139 0 2139 2141 2137 2138 2138 0 0 0 0
2147 2149 2145 2146 2147 1366 2147 2149 2145 2146 2146 0 0 0 0
0 0 0 0 0 1367 0 0 0 0 0 0 0 0 0
0 0 0 0 0 0 0 0 0 0 0 0 0 0 0
0 0 0 0 0 0 0 0 0 0 0 0 0 0 0
0 0 0 0 0 0 0 0 0 0 0 0 0 0 0

