house3_room2 58
10 10
3
1 room-01-udw
1113 room-01-udx
2329 add_more
5
0 0 0 0 0 0 0 0 0 0
0 0 0 0 0 0 0 0 0 0
0 0 0 0 0 0 0 0 0 0
0 2640 2640 2640 2640 2640 2640 2640 2640 2640
0 2640 2640 2640 2640 2640 2640 2640 2640 2640
0 2640 2640 2640 2640 2640 2640 2640 2640 2640
2640 2640 2640 2640 2640 2640 2640 2640 2640 2640
0 2640 2640 2640 2640 2640 2640 2640 2640 2640
0 2640 0 2640 2640 2640 2640 2640 2640 2640
0 0 0 0 2640 2640 2640 2640 2640 2640

0 1033 1034 1035 1036 1037 1038 1039 1040 1059
0 1041 1042 1043 1044 1045 1046 1047 1048 1067
0 1049 1050 1051 1052 1053 1054 1055 1056 1075
1064 1 2 3 1 2 3 4 3 4
1072 1 2 3 1 2 3 4 3 4
1080 1 2 3 1 2 3 4 3 4
1 1 2 3 1 2 3 4 3 4
0 1 2 3 1 2 3 4 3 4
0 1 2 3 1 2 3 4 4 4
0 1 2 3 4 1 2 3 4 4

0 0 0 0 0 0 0 0 0 0
0 0 0 0 0 2669 0 0 0 0
0 2154 2155 0 0 0 0 0 0 2156
0 2162 2163 0 0 0 0 0 0 2164
0 0 0 0 0 0 0 0 0 0
0 0 0 0 0 0 0 0 0 0
0 0 0 0 0 0 0 0 0 0
0 0 0 0 0 0 0 0 0 0
0 0 1942 0 0 0 0 0 0 0
0 0 0 0 0 0 0 0 0 0

0 0 0 0 0 0 0 0 0 0
0 0 0 0 0 0 0 0 0 0
0 0 0 0 0 0 0 0 0 0
0 0 0 0 0 0 0 0 0 0
0 0 0 0 0 0 0 0 0 0
0 0 0 0 0 0 0 0 0 0
0 0 0 0 0 0 0 0 0 0
0 0 0 0 0 0 0 0 0 0
0 0 1950 0 0 0 0 0 0 0
0 1957 1958 1959 0 0 0 0 0 0

0 0 0 0 0 0 0 0 0 0
0 0 0 0 0 0 0 0 0 0
0 0 0 0 0 0 0 0 0 0
0 0 0 0 0 0 0 0 0 0
0 0 0 0 0 0 0 0 0 0
0 0 0 0 0 0 0 0 0 0
0 0 0 0 0 0 0 0 0 0
0 0 1934 0 0 0 0 0 0 0
0 1949 0 1951 0 0 0 0 0 0
0 0 0 0 0 0 0 0 0 0

