house3_hallway2 55
9 18
3
1 room-01-udw
1113 add_more
1625 room-01-udz
3
0 0 0 0 0 0 0 0 0
0 0 0 0 0 0 0 0 0
0 0 0 0 0 0 0 0 0
0 1424 1424 1424 0 1424 1424 1424 0
1424 1424 0 1424 1424 1424 0 1424 1424
1424 1424 0 1424 1424 1424 0 1424 1424
1424 1424 1424 1424 1424 1424 1424 1424 1424
1424 1424 1424 1424 1424 1424 1424 1424 1424
0 0 0 1424 1424 1424 0 0 0
1424 1424 1424 1424 1424 1424 1424 1424 1424
0 0 0 1424 1424 1424 0 0 0
1424 1424 1424 1424 1424 1424 1424 1424 1424
0 0 0 1424 1424 1424 0 0 0
1424 1424 1424 1424 1424 1424 1424 1424 1424
1424 1424 1424 1424 1424 1424 1424 1424 1424
1424 1424 1424 1424 1424 1424 1424 1424 1424
1424 1424 1424 1424 1424 1424 1424 1424 1424
0 0 0 0 1424 0 0 0 0

0 1082 1083 1084 1085 1086 1083 1082 0
0 1090 1091 1092 1093 1094 1091 1090 0
0 1098 1099 1100 1101 1102 1099 1098 0
265 1481 1482 1482 1887 1482 1482 1483 268
273 1497 1498 1498 1498 1498 1498 1499 276
276 1497 1498 1498 1498 1498 1498 1499 276
284 1513 1514 1468 1498 1469 1514 1515 284
292 292 292 1497 1498 1499 292 292 292
275 276 277 1497 1498 1499 275 276 277
284 284 284 1497 1498 1499 284 284 284
275 276 277 1497 1498 1499 275 276 277
284 284 284 1497 1498 1499 284 284 284
275 276 277 1497 1498 1499 275 276 277
284 284 284 1513 1514 1515 284 284 284
292 291 290 290 290 290 291 291 292
300 300 300 300 300 300 300 300 300
300 300 300 300 300 300 300 300 300
0 0 0 0 301 0 0 0 0

1081 0 0 0 0 0 0 0 1088
1089 0 0 0 0 0 0 0 1096
1097 0 0 0 0 0 0 0 1104
1105 0 0 0 0 0 0 0 1112
0 0 920 0 0 0 920 0 0
0 0 928 0 0 0 928 0 0
0 0 0 0 0 0 0 0 0
0 0 0 0 0 0 0 0 0
905 906 907 0 0 0 905 906 907
0 0 0 0 0 0 0 0 0
913 914 915 0 0 0 913 914 915
0 0 0 0 0 0 0 0 0
921 922 923 0 0 0 921 922 923
0 0 0 0 0 0 0 0 0
0 0 0 0 0 0 0 0 0
0 0 0 0 0 0 0 0 0
0 0 0 0 0 0 0 0 0
0 0 0 0 0 0 0 0 0

