house1_hallway1
10 5
2
1 add_more
513 room-01-udy
4
0 0 0 0 0 0 0 0 0 0
0 0 0 0 0 0 0 0 0 0
312 312 312 312 312 312 312 312 312 0
312 312 312 312 312 312 312 312 312 312
312 312 312 312 312 312 312 312 312 0

12 12 12 12 12 12 12 12 12 28
12 12 12 12 12 12 12 12 12 12
513 514 515 516 513 514 515 516 513 12
513 514 515 516 513 514 515 516 513 514
513 514 515 516 513 514 515 516 513 28

521 521 521 521 521 521 521 521 521 0
529 529 529 529 529 529 529 529 529 521
0 0 0 0 0 0 0 0 0 529
0 0 0 0 0 0 0 0 0 0
0 0 0 0 0 0 0 0 0 0

0 0 0 0 9 0 0 0 0 0
0 0 0 0 25 0 0 0 0 0
0 0 0 0 0 0 0 0 0 0
0 0 0 0 0 0 0 0 0 0
0 0 0 0 0 0 0 0 0 0

