house3_basement7 52
18 13
6
1 room-01-udw
1113 add_more
1625 room-01-udy
2041 room-01-udz
2937 room-01-ud
3305 room-01-udw3
4
0 0 0 0 0 0 0 0 0 0 0 0 0 0 0 0 0 0
0 0 0 0 0 0 0 0 0 0 0 0 0 0 0 0 0 0
1424 1424 1424 1424 1424 1424 1424 1424 1424 1424 1424 1424 1424 1424 1424 1424 1424 1424
0 0 0 0 0 0 0 0 0 0 0 0 0 0 0 0 1424 0
1424 1424 1424 1424 1424 1424 1424 1424 1424 1424 1424 1424 1424 1424 1424 1424 1424 1424
1424 1424 1424 1424 1424 1424 1424 1424 1424 1424 1424 1424 1424 1424 1424 1424 1424 1424
1424 1424 1424 1424 1424 1424 1424 1424 1424 1424 1424 1424 1424 1424 1424 1424 1424 1424
1424 1424 1424 1424 1424 1424 1424 1424 1424 1424 1424 1424 1424 1424 1424 1424 1424 1424
1424 1424 1424 1424 1424 1424 1424 1424 1424 1424 1424 1424 1424 1424 1424 1424 1424 1424
1424 1424 1424 1424 1424 1424 1424 1424 1424 1424 1424 1424 1424 1424 1424 1424 1424 1424
1424 1424 1424 1424 1424 1424 1424 1424 1424 1424 1424 1424 1424 1424 1424 1424 1424 1424
1424 1424 1424 1424 1424 1424 1424 1424 1424 1424 1424 1424 1424 1424 1424 1424 1424 1424
1424 1424 1424 1424 1424 1424 1424 1424 1424 1424 1424 1424 1424 1424 1424 1424 1424 1424

3441 1431 3443 3444 3445 3446 3447 3448 3441 3442 3443 3444 3445 3446 3447 3448 3441 3442
3449 1447 3451 3452 3453 3454 3455 3456 3449 3450 3451 3452 3453 3454 3455 3456 3449 3450
3305 3306 3307 3308 3305 3306 3307 3308 3305 3306 3307 3308 3305 3306 3307 3308 3305 3306
3305 3306 3307 3308 3305 3306 3307 3308 3305 3306 3307 3308 3305 3306 3307 3308 3305 3306
3305 3306 3307 3308 3305 3306 3307 3308 3305 3306 3307 3308 3305 3306 3307 3308 3305 3306
3305 3306 3307 3308 3305 3306 3307 3308 3305 3306 3307 3308 3305 3306 3307 3308 3305 3306
3305 3306 3307 3308 3305 3306 3307 3308 3305 3306 3307 3308 3305 3306 3307 3308 3305 3306
3305 3306 3307 3308 3305 3306 3307 3308 3305 3306 3307 3308 3305 3306 3307 3308 3305 3306
3305 3306 3307 3308 3305 3306 3307 3308 3305 3306 3307 3308 3305 3306 3307 3308 3305 3306
3305 3306 3307 3308 3305 3306 3307 3308 3305 3306 3307 3308 3305 3306 3307 3308 3305 3306
3305 3306 3307 3308 3305 3306 3307 3308 3305 3306 3307 3308 3305 3306 3307 3308 3305 3306
3305 3306 3307 3308 3305 3306 3307 3308 3306 3307 3308 3308 3305 3306 3307 3308 3305 3306
3305 3306 3307 3308 3305 3306 3307 3308 3305 3306 3307 3308 3305 3306 3307 3308 3305 3306

0 0 0 0 0 0 0 0 0 0 0 0 0 0 0 0 0 0
0 0 0 0 0 0 0 0 0 0 0 0 0 0 0 0 0 0
0 0 0 0 0 0 0 0 0 0 0 0 0 0 0 0 0 0
3385 3386 3386 3386 3386 3386 3386 3386 3386 3386 3386 3386 3386 3386 3386 3387 0 3385
0 0 0 0 0 0 0 0 0 0 0 0 0 0 0 0 0 0
0 0 0 0 0 0 0 0 0 0 0 0 0 0 0 0 0 0
0 0 0 0 0 0 0 0 0 0 0 0 0 0 0 0 0 0
0 0 0 0 0 0 0 0 0 0 0 0 0 0 0 0 0 0
0 0 0 0 0 0 0 0 0 0 0 0 0 0 0 0 0 0
0 0 0 0 0 0 0 0 0 0 0 0 0 0 0 0 0 0
0 0 0 0 0 0 0 0 0 0 0 0 0 0 0 0 0 0
0 0 0 0 0 0 0 0 0 0 0 0 0 0 0 0 0 0
0 0 0 0 0 0 0 0 0 0 0 0 0 0 0 0 0 0

0 0 0 0 0 0 0 0 0 0 0 0 0 0 0 0 0 0
0 0 0 0 0 0 0 0 0 0 0 0 0 0 0 0 0 0
3377 3378 3378 3378 3378 3378 3378 3378 3378 3378 3378 3378 3378 3378 3378 3379 0 3377
0 0 0 0 0 0 0 0 0 0 0 0 0 0 0 0 0 0
0 0 0 0 0 0 0 0 0 0 0 0 0 0 0 0 0 0
0 0 0 0 0 0 0 0 0 0 0 0 0 0 0 0 0 0
0 0 0 0 0 0 0 0 0 0 0 0 0 0 0 0 0 0
0 0 0 0 0 0 0 0 0 0 0 0 0 0 0 0 0 0
0 0 0 0 0 0 0 0 0 0 0 0 0 0 0 0 0 0
0 0 0 0 0 0 0 0 0 0 0 0 0 0 0 0 0 0
0 0 0 0 0 0 0 0 0 0 0 0 0 0 0 0 0 0
0 0 0 0 0 0 0 0 0 0 0 0 0 0 0 0 0 0
0 192 0 0 0 0 0 0 0 0 0 0 0 0 0 0 0 0

