house3_basement5 50
9 10
7
1 room-01-udw
1113 add_more
1625 room-01-udy
2041 room-01-udz
2937 room-01-ud
3305 room-01-udw3
3489 room-01-udx
5
0 0 0 0 0 0 0 0 0
0 0 0 0 0 0 0 0 0
1424 1424 1424 1424 1424 1424 1424 1424 1424
1424 1424 1424 1424 1424 1424 1424 1424 1424
1424 1424 1424 1424 1424 1424 1424 1424 1424
1424 1424 1424 1424 0 1424 1424 1424 1424
1424 1424 1424 1424 1424 1424 1424 1424 1424
1424 1424 1424 1424 1424 1424 1424 1424 1424
1424 1424 1424 1424 1424 1424 1424 1424 1424
1424 1424 1424 1424 1424 1424 1424 1424 1424

812 812 812 812 1431 812 812 812 812
820 820 820 820 1447 820 820 820 820
1 2 3 4 1 2 3 4 4
1 2 3 4 1 1 1 2 3
1 2 3 4 1 2 1 2 3
1 2 3 4 1 2 1 2 3
1 2 3 4 1 1 2 3 4
1 2 3 4 1 1 2 3 4
1 2 3 4 1 1 2 3 4
1 1 1 1 1 1 2 3 4

0 0 0 0 0 0 0 0 0
3414 3414 0 0 0 0 0 0 4532
3422 3422 0 0 0 0 0 0 4540
0 0 0 0 0 0 0 0 0
0 0 0 0 0 0 0 0 0
0 0 0 0 0 0 0 0 0
0 0 0 0 0 0 0 0 0
0 0 0 0 0 0 0 0 0
0 0 0 0 0 0 0 0 0
0 0 0 0 0 0 0 0 0

0 0 0 0 0 0 0 0 0
1024 0 0 0 0 0 0 0 0
0 0 0 0 0 0 0 0 0
0 0 0 0 0 0 0 0 0
0 0 0 0 0 0 0 0 0
0 0 0 0 1367 0 0 0 0
0 0 0 0 0 0 0 0 0
0 0 0 0 0 0 0 0 0
0 0 0 0 0 0 0 0 0
0 0 0 0 0 0 0 0 0

0 0 0 0 0 0 0 0 0
0 0 0 0 0 0 0 0 0
0 0 0 0 0 0 0 0 0
0 0 0 0 0 0 0 0 0
0 0 0 0 1366 0 0 0 0
0 0 0 0 0 0 0 0 0
0 0 0 0 0 0 0 0 0
0 0 0 0 0 0 0 0 0
0 0 0 0 0 0 0 0 0
0 0 0 0 192 0 0 0 0

