house3_basement8 53
21 8
6
1 room-01-udw
1113 add_more
1625 room-01-udy
2041 room-01-udz
2937 room-01-ud
3305 room-01-udw3
3
0 0 0 0 0 0 0 0 0 0 0 0 0 0 0 0 0 0 0 0 0
0 0 0 0 0 0 0 0 0 0 0 0 0 0 0 0 0 0 0 1424 1424
0 0 0 0 0 0 0 0 0 0 0 0 1424 1424 1424 1424 1424 1424 1424 1424 1424
0 0 0 0 0 1424 1424 1424 1424 1424 1424 1424 1424 1424 1424 1424 1424 1424 1424 1424 1424
1424 1424 1424 1424 1424 1424 1424 1424 1424 1424 1424 1424 1424 1424 1424 1424 1424 1424 1424 1424 1424
1424 1424 1424 1424 1424 1424 1424 1424 1424 1424 1424 1424 1424 0 0 0 0 0 0 0 0
1424 1424 1424 1424 1424 1424 0 0 0 0 0 0 0 0 0 0 0 0 0 0 0
0 1424 0 0 0 0 0 0 0 0 0 0 0 0 0 0 0 0 0 0 0

0 0 0 0 0 0 0 0 0 0 0 0 812 812 812 812 812 812 812 0 0
0 0 0 0 0 812 812 812 812 812 812 812 820 820 820 820 820 820 820 0 0
812 812 812 820 812 820 820 820 820 820 820 820 313 313 313 313 313 313 313 313 313
820 820 820 820 820 313 313 313 313 313 313 313 313 313 313 313 313 313 313 313 313
313 313 313 313 313 313 313 313 313 313 313 313 313 313 313 313 313 313 313 313 313
313 313 313 313 313 313 313 313 313 313 313 313 313 0 0 0 0 0 0 0 0
313 313 313 313 313 313 0 0 0 0 0 0 0 0 0 0 0 0 0 0 0
0 313 0 0 0 0 0 0 0 0 0 0 0 0 0 0 0 0 0 0 0

0 0 0 0 0 0 0 0 0 0 0 0 0 0 0 0 0 0 0 294 295
0 0 0 0 0 0 0 0 0 0 0 0 0 0 0 0 0 0 0 294 295
0 0 0 0 0 0 0 0 0 0 0 0 0 0 0 0 0 0 0 302 303
0 0 0 0 0 0 0 0 0 0 0 0 0 0 0 0 0 0 0 0 0
0 0 0 0 0 0 0 0 0 0 0 0 0 0 0 0 0 0 0 0 0
0 0 0 0 0 0 0 0 0 0 0 0 0 0 0 0 0 0 0 0 0
0 0 0 0 0 0 0 0 0 0 0 0 0 0 0 0 0 0 0 0 0
0 0 0 0 0 0 0 0 0 0 0 0 0 0 0 0 0 0 0 0 0

