house3_room1 57
11 10
5
1 room-01-udw
1113 room-01-ud
1481 room-01-udx
2697 add_more
3209 room-01-udw3
4
0 0 0 0 0 0 0 0 0 0 0
0 0 0 0 0 0 0 0 0 0 0
0 3008 3008 3008 3008 3008 3008 3008 3008 3008 3008
0 3008 3008 3008 3008 3008 3008 3008 0 3008 3008
0 3008 3008 3008 3008 3008 3008 3008 3008 3008 3008
0 3008 3008 3008 3008 3008 3008 3008 3008 3008 3008
3008 3008 3008 3008 3008 3008 3008 3008 3008 3008 3008
0 3008 3008 3008 3008 3008 3008 3008 3008 3008 3008
0 0 0 3008 3008 3008 3008 3008 3008 3008 3008
0 0 0 3008 3008 3008 3008 3008 3008 3008 3008

0 1033 1034 1035 1036 1037 1038 1039 1040 1033 1034
0 1041 1042 1043 1044 1045 1046 1047 1048 1041 1042
0 1 2 3 126 1 2 3 126 1 2
0 1 2 3 4 1 2 127 119 120 2
1060 1 2 3 4 1 2 3 110 1 2
1068 1 2 3 4 1 2 3 4 1 2
1 1 2 3 4 1 2 3 4 126 2
0 1 2 3 4 1 2 3 4 1 2
0 1 2 3 4 1 2 3 4 1 2
0 1 2 3 4 126 2 3 4 1 2

0 671 672 0 0 0 0 0 0 0 0
0 679 680 954 0 0 0 0 0 0 0
0 687 688 961 0 0 0 0 0 0 0
0 0 0 0 0 0 0 0 0 0 0
0 0 0 0 0 0 0 0 0 0 0
0 0 0 0 0 0 0 0 0 0 0
0 0 0 0 0 0 0 0 0 0 0
0 0 0 0 0 0 0 0 0 0 0
0 0 0 0 0 0 0 0 0 0 0
0 0 0 0 0 0 0 0 0 0 0

0 0 0 0 0 0 0 0 0 0 0
0 0 0 0 0 0 0 0 0 0 0
0 0 0 0 0 0 0 0 0 0 0
0 0 0 0 0 0 0 0 0 0 0
0 0 0 0 0 0 0 0 0 0 0
0 0 0 0 0 0 0 0 0 0 0
0 0 0 0 0 0 0 0 0 0 0
0 75 76 0 0 0 0 0 0 0 0
0 83 84 0 0 0 0 0 0 0 0
0 73 74 0 0 0 0 0 0 3320 0

