house3_room6 62
16 14
5
1 room-01-udw
1113 add_more
1625 room-01-udy
2041 room-01-udz
2937 room-01-ud
6
0 0 0 0 0 0 0 0 0 0 0 0 0 0 0 0
0 0 0 0 0 0 0 0 0 0 0 0 0 0 0 0
0 0 0 0 0 0 0 0 0 0 0 0 0 0 0 0
0 0 0 0 0 0 0 0 0 0 0 0 0 1424 1424 1424
0 0 0 0 0 0 0 0 0 0 0 0 0 1424 1424 1424
1424 1424 1424 1424 1424 1424 0 0 0 0 0 0 1424 1424 1424 1424
0 0 0 1424 1424 1424 1424 1424 1424 1424 1424 1424 1424 1424 1424 1424
1424 1424 1424 1424 1424 1424 1424 1424 1424 1424 1424 1424 1424 1424 1424 1424
1424 1424 1424 1424 1424 1424 1424 1424 1424 1424 1424 1424 1424 1424 1424 1424
1424 1424 1424 1424 1424 1424 1424 1424 1424 1424 1424 1424 1424 1424 1424 1424
0 0 0 1424 1424 1424 1424 1424 1424 1424 1424 1424 1424 1424 1424 1424
1424 1424 1424 1424 1424 1424 1424 1424 1424 1424 1424 1424 1424 1424 1424 1424
1424 1424 1424 1424 1424 1424 1424 1424 1424 1424 1424 1424 1424 1424 1424 1424
0 0 0 0 0 0 0 1424 0 0 0 0 0 0 0 0

0 0 0 0 0 0 0 0 0 0 0 0 0 1033 1034 1035
0 0 0 0 0 0 0 0 0 0 0 0 0 1041 1042 1043
1036 1037 1038 1039 1040 1033 1034 1035 1036 1037 1038 1039 1040 1049 1050 1051
1044 1045 1046 1047 1048 1041 1042 1043 1044 1045 1046 1047 1048 1 2 3
1052 1053 1054 1055 1056 1049 1050 1051 1052 1053 1054 1055 1056 1 2 3
1 2 3 4 1 2 3 4 1 2 3 4 1 2 3 4
1 2 3 4 1 2 3 4 1 2 3 4 1 2 3 4
1 2 3 4 1 2 3 4 1 2 3 4 1 2 3 4
1 2 3 4 1 2 3 4 1 2 3 4 1 2 3 4
1 2 3 4 1 2 3 4 1 2 3 4 1 2 3 4
1 2 3 4 1 2 3 4 1 2 3 4 1 2 3 4
1 2 3 4 1 2 3 4 1 2 3 4 1 2 3 4
1 2 3 4 1 2 3 1 1 2 3 4 1 2 3 4
0 0 0 0 0 0 0 2 0 0 0 0 0 0 0 0

0 0 0 0 0 0 0 0 0 0 0 0 0 0 0 0
0 0 0 0 0 0 0 0 0 0 0 0 0 0 0 0
0 0 0 0 0 0 0 0 0 0 0 0 0 0 0 0
0 0 0 0 0 0 966 0 959 0 967 0 0 0 0 0
0 0 0 0 0 0 477 478 478 478 478 479 0 0 0 0
0 0 0 0 0 0 485 486 486 486 486 487 0 0 0 0
0 0 0 0 0 0 493 494 494 494 494 495 0 0 0 0
0 0 0 0 0 0 0 0 0 0 0 0 0 0 0 0
0 0 0 0 0 0 0 0 0 0 0 0 0 0 0 0
0 0 0 0 0 0 0 0 0 0 0 0 0 0 0 0
0 0 0 0 0 0 0 0 0 0 0 0 0 0 0 0
0 0 0 0 0 0 0 0 0 0 0 0 0 0 0 0
0 0 0 0 0 0 0 0 0 0 0 0 0 0 0 0
0 0 0 0 0 0 0 0 0 0 0 0 0 0 0 0

0 0 0 0 0 0 0 0 0 0 0 0 0 0 0 0
0 0 0 0 0 0 0 0 0 0 0 0 0 0 0 0
0 0 0 0 0 0 0 0 0 0 0 0 0 0 1454 0
0 0 0 0 0 0 0 0 0 0 0 0 0 0 0 0
0 0 0 0 0 0 0 0 1032 0 0 0 0 0 0 0
0 0 0 0 0 0 0 1015 1014 2004 0 0 0 0 0 0
3233 3234 3235 0 0 0 0 0 0 0 0 0 0 0 0 0
3241 3242 3243 0 0 0 0 0 0 0 0 0 0 0 0 0
0 0 0 0 0 0 0 0 0 0 0 0 0 0 0 0
0 0 0 0 0 0 0 0 0 0 0 0 0 0 0 0
3233 3234 3235 0 0 0 0 0 0 0 0 0 0 0 0 0
3241 3242 3243 0 0 0 0 0 0 0 0 0 0 0 0 0
0 0 0 0 0 0 0 0 0 0 0 0 0 0 0 0
0 0 0 0 0 0 0 0 0 0 0 0 0 0 0 0

0 0 0 0 0 0 0 0 0 0 0 0 0 0 0 0
0 0 0 0 0 0 0 0 0 0 0 0 0 0 0 0
0 0 0 0 0 0 0 0 0 0 0 0 0 0 0 0
0 0 0 0 0 0 0 0 0 0 0 0 0 0 0 0
3217 3218 3219 0 0 0 0 0 0 0 0 0 0 0 0 0
3225 3226 3227 0 0 0 0 0 0 0 0 0 0 0 0 0
0 0 0 0 0 0 0 0 0 0 0 0 0 0 0 0
0 0 0 0 0 0 0 0 0 0 0 0 0 0 0 0
0 0 0 0 0 0 0 0 0 0 0 0 0 0 0 0
0 0 0 0 0 0 0 0 0 0 0 0 0 0 0 0
0 0 0 0 0 0 0 0 0 0 0 0 0 0 0 0
0 0 0 0 0 0 0 0 0 0 0 0 0 0 0 0
0 0 0 0 0 0 0 0 0 0 0 0 0 0 0 0
0 0 0 0 0 0 0 0 0 0 0 0 0 0 0 0

0 0 0 0 0 0 0 0 0 0 0 0 0 0 0 0
0 0 0 0 0 0 0 0 0 0 0 0 0 0 0 0
0 0 0 0 0 0 0 0 0 0 0 0 0 0 0 0
0 0 0 0 0 0 0 0 0 0 0 0 0 0 0 0
0 0 0 0 0 0 0 0 0 0 0 0 0 0 0 0
0 0 0 0 0 0 0 0 0 0 0 0 0 0 0 0
0 0 0 0 0 0 0 0 0 0 0 0 0 0 0 0
0 0 0 0 0 0 0 0 0 0 0 0 0 0 0 0
3217 3218 3219 0 0 0 0 0 0 0 0 0 0 0 0 0
3225 3226 3227 0 0 0 0 0 0 0 0 0 0 0 0 0
0 0 0 0 0 0 0 0 0 0 0 0 0 0 0 0
0 0 0 0 0 0 0 0 0 0 0 0 0 0 0 0
0 0 0 0 0 0 0 0 0 0 0 0 0 0 0 0
0 0 0 0 0 0 0 0 0 0 0 0 0 0 0 0

