house3_room4 60
9 12
4
1 room-01-udw
1113 add_more
1625 room-01-udy
2041 room-01-udz
5
0 0 0 0 0 0 0 0 0
0 0 0 0 0 0 0 0 0
1424 1424 1424 1424 1424 1424 1424 1424 1424
0 1424 1424 1424 1424 1424 1424 1424 1424
1424 1424 1424 1424 1424 1424 1424 1424 1424
1424 1424 1424 1424 1424 1424 1424 1424 1424
1424 1424 1424 1424 1424 1424 1424 1424 1424
1424 1424 1424 1424 1424 1424 1424 1424 1424
1424 1424 1424 1424 1424 1424 1424 1424 1424
0 0 1424 1424 1424 1424 1424 1424 1424
0 0 1424 1424 1424 1424 1424 1424 1424
0 0 0 0 1424 0 0 0 0

1430 1430 1430 1430 1426 1427 1428 1429 1430
1446 1446 1446 1446 1442 1443 1444 1445 1446
1 1 1 1 1 1 1 2 3
1 2 3 4 1 2 3 4 1
1 2 3 4 1 109 4 4 1
1 1 1 2 3 1 2 3 1
1 2 1 2 1 1 2 3 1
1 2 1 1 1 1 2 3 1
1 1 1 1 2 1 2 3 1
1 126 3 4 1 1 2 4 4
1 2 3 4 1 1 2 3 4
0 0 0 0 3 0 0 0 0

2185 2186 2187 2188 0 0 0 0 0
2193 2194 2195 2196 0 0 0 0 0
2201 2202 2203 2204 0 0 0 0 0
2220 0 0 0 0 0 0 0 0
0 0 0 0 0 0 0 0 0
0 0 0 0 0 0 0 0 0
0 0 0 0 0 0 0 0 0
0 0 0 0 0 0 0 0 0
0 0 0 0 0 0 0 0 0
2035 2036 0 0 0 0 0 0 0
2025 2026 0 0 0 0 0 0 0
0 0 0 0 0 0 0 0 0

0 0 0 0 0 0 0 0 0
0 0 0 0 0 0 0 0 0
0 0 0 0 0 0 0 0 0
2212 0 0 0 0 0 0 0 0
0 0 0 0 0 0 0 0 0
0 0 0 0 0 0 0 0 0
0 0 0 0 0 0 0 0 0
0 0 0 0 0 0 0 0 0
0 0 0 0 0 0 0 0 0
0 0 0 0 0 0 0 0 0
0 0 0 0 0 0 0 0 0
0 0 0 0 0 0 0 0 0

0 0 0 0 0 0 0 0 0
0 0 0 0 0 0 0 0 0
0 0 0 0 0 0 0 0 0
0 0 0 0 0 0 0 0 0
0 0 0 0 0 0 0 0 0
0 0 0 0 0 0 0 0 0
0 0 0 0 0 0 0 0 0
0 0 0 0 0 0 0 0 0
2027 2028 0 0 0 0 0 0 0
0 0 0 0 0 0 0 0 0
0 0 0 0 0 0 0 0 0
0 0 0 0 0 0 0 0 0

