ouside1_1 63
20 15
2
1 003-Forest01
409 add_more
8
0 0 0 0 0 0 0 0 0 0 0 0 0 0 0 0 0 0 0 0
0 0 0 0 0 0 0 0 0 0 0 0 0 0 0 0 0 0 0 0
0 0 0 0 0 0 0 0 0 0 0 0 0 0 0 0 0 0 0 0
0 0 0 0 0 0 0 0 0 0 0 0 0 0 0 0 0 0 0 0
0 0 0 0 0 0 0 0 0 0 0 0 0 0 0 0 0 0 0 0
0 0 0 0 0 0 0 0 0 0 0 0 0 0 0 0 0 0 0 0
0 0 0 0 0 0 0 0 0 0 0 0 0 0 0 0 0 0 0 0
0 0 0 0 0 0 0 720 720 720 0 0 0 0 0 0 0 0 0 0
0 0 0 0 0 0 720 720 720 720 720 720 720 0 0 0 0 0 0 0
0 0 0 0 0 720 720 720 720 720 720 720 720 720 720 720 720 720 720 720
0 0 0 0 0 720 720 720 720 720 720 720 720 720 720 720 720 720 720 720
0 0 0 0 0 720 720 720 720 720 720 720 720 720 720 720 720 720 720 720
0 0 0 0 0 720 720 720 720 720 720 720 720 720 720 720 720 720 720 720
0 0 0 0 0 0 720 0 0 0 0 0 0 0 0 0 0 0 0 0
0 0 0 0 0 0 0 0 0 0 0 0 0 0 0 0 0 0 0 0

3 3 3 3 3 3 3 3 3 3 3 3 3 3 3 3 3 3 3 3
3 3 3 3 3 3 3 3 3 3 3 3 3 3 3 3 3 3 3 3
3 3 3 3 3 3 3 3 3 3 3 3 3 3 3 3 3 3 3 3
3 3 3 3 3 3 3 3 3 3 3 3 3 3 3 3 3 3 3 3
3 3 3 3 3 3 3 3 3 3 3 3 3 3 3 3 3 3 3 3
3 3 3 3 3 3 3 3 3 3 3 3 3 3 3 3 3 3 3 3
3 3 3 3 3 3 1 1 1 1 1 3 3 3 3 3 3 3 3 3
3 3 3 3 3 1 1 9 9 9 1 1 1 1 3 3 3 3 3 3
3 3 3 3 1 1 9 9 9 9 9 9 9 1 1 1 1 1 1 1
3 3 3 3 1 9 9 9 9 9 9 9 9 9 9 9 9 9 9 9
3 3 3 3 1 9 9 9 9 9 9 9 9 9 9 9 9 9 9 9
3 3 3 3 1 9 9 9 9 9 9 9 9 9 9 9 9 9 9 9
3 3 3 3 1 1 9 9 9 9 9 9 9 9 9 9 9 9 9 9
3 3 3 3 1 1 9 1 1 1 1 1 1 1 9 9 9 1 1 1
436 436 436 436 436 436 436 436 436 436 436 436 436 1 1 1 1 1 1 1

0 0 0 0 0 0 0 0 0 0 0 0 0 0 0 0 0 0 0 0
0 0 0 0 0 0 0 0 0 0 0 0 0 0 0 0 0 0 0 0
0 0 0 0 0 0 0 0 0 0 0 0 0 0 0 0 0 0 0 0
0 0 0 0 0 0 0 0 0 0 0 0 0 0 0 0 0 0 0 0
0 0 0 0 0 0 0 0 0 0 0 0 0 0 0 0 0 0 0 0
0 0 0 0 0 0 120 119 120 119 119 0 0 0 0 0 0 0 0 0
0 0 0 0 0 119 128 127 128 127 127 119 120 120 0 0 0 0 0 0
0 0 0 0 120 127 0 0 0 0 0 127 128 128 120 120 120 119 120 120
0 0 0 0 128 0 0 7 0 7 0 0 0 0 128 128 128 127 128 128
0 0 0 0 128 7 0 0 0 7 0 6 0 6 0 0 0 0 0 0
0 0 0 0 128 0 0 7 0 0 0 0 0 7 0 0 7 7 0 7
0 0 0 0 128 0 0 0 7 0 7 0 8 0 0 0 0 7 0 0
0 0 0 0 128 0 7 0 0 0 0 0 0 0 0 0 0 0 0 0
0 0 0 0 128 120 0 119 120 119 119 119 120 120 120 120 120 119 120 120
0 0 0 0 0 0 0 0 0 0 0 0 0 128 128 128 128 127 128 128

0 0 21 0 0 0 0 29 0 0 49 50 51 52 53 54 0 0 0 0
0 0 29 0 0 0 0 0 0 0 57 58 59 60 61 62 0 0 0 0
27 28 0 0 0 0 0 0 0 0 65 66 67 68 69 70 0 0 0 0
0 0 0 0 0 0 0 0 25 26 0 0 0 0 0 0 0 0 0 0
0 0 0 0 0 0 0 0 0 0 0 0 0 0 0 0 0 0 0 0
0 0 0 0 0 0 0 0 0 0 0 0 0 0 21 0 0 0 0 0
0 0 0 0 0 0 0 0 0 0 0 0 0 0 29 0 0 0 0 0
0 0 0 0 0 0 0 0 0 0 0 0 0 0 0 0 0 0 0 0
0 0 0 0 0 0 0 0 0 0 0 0 0 0 0 0 0 0 0 0
0 0 0 0 0 0 0 0 0 0 0 0 0 0 0 0 0 0 0 0
0 0 0 0 0 0 0 0 0 0 0 0 0 0 0 0 0 0 0 0
0 0 0 0 0 0 0 0 0 0 0 0 0 0 0 0 0 0 0 0
0 0 0 0 0 0 0 0 0 0 0 0 0 0 0 0 0 0 0 0
0 0 0 0 0 0 0 0 0 0 0 0 0 0 0 0 0 0 0 0
0 0 0 0 0 0 0 0 0 0 0 0 0 0 0 0 0 0 0 0

0 0 0 0 0 0 0 0 0 0 0 0 0 0 0 0 0 0 0 0
0 0 0 0 0 0 0 0 0 0 0 0 0 0 0 0 0 0 0 0
0 0 0 0 0 0 0 0 0 0 0 0 0 0 0 0 0 0 0 0
0 0 0 0 0 0 0 0 0 0 0 0 0 0 0 23 24 0 0 0
0 22 0 0 0 0 0 0 0 0 0 0 0 0 0 0 0 0 0 0
0 30 0 0 0 0 0 0 0 0 0 0 0 0 0 0 0 0 0 0
0 0 0 0 0 0 0 0 0 0 0 0 0 0 0 0 0 0 0 0
0 0 0 0 0 0 0 0 0 0 0 0 0 0 0 0 0 0 0 0
0 0 0 0 0 0 0 0 0 0 0 0 0 0 0 0 0 0 0 0
0 0 0 0 0 0 0 0 0 0 0 0 0 0 0 0 0 0 0 0
0 0 0 0 0 0 0 0 0 0 0 0 0 0 0 0 0 0 0 0
39 40 0 0 0 0 0 0 0 0 0 0 0 0 0 0 0 0 0 0
0 0 0 22 0 0 0 0 0 0 0 0 0 0 0 0 0 0 0 0
0 0 0 30 0 0 0 0 0 0 0 0 0 0 0 0 0 0 0 0
0 0 0 0 0 0 0 0 0 0 0 0 0 0 0 0 0 0 0 0

0 0 0 0 0 0 0 0 0 0 0 0 0 0 0 0 0 0 0 0
0 0 0 0 0 0 0 0 0 33 34 35 36 37 38 0 0 0 0 0
0 0 0 0 0 0 0 0 0 41 42 43 44 45 46 0 0 0 0 0
0 0 0 0 0 0 0 0 0 49 50 51 52 53 54 0 0 0 0 0
0 0 0 0 0 0 0 0 0 57 58 59 60 61 62 0 0 0 0 0
0 0 0 0 0 0 0 0 0 65 66 67 68 69 70 0 0 0 0 0
0 0 0 0 0 0 0 0 0 0 0 0 0 0 0 0 0 0 0 0
0 0 0 0 0 0 0 0 0 0 0 0 0 0 0 0 0 0 0 0
0 0 0 0 0 0 0 0 0 0 0 0 0 0 0 0 0 0 0 0
0 0 0 0 0 0 0 0 0 0 0 0 0 0 0 0 0 0 0 0
0 0 0 0 0 0 0 0 0 0 0 0 0 0 0 0 0 0 0 0
0 0 0 0 0 0 0 0 0 0 0 0 0 0 0 0 0 0 0 0
0 0 0 0 0 0 0 0 0 0 0 0 0 0 0 0 0 0 0 0
0 0 0 0 0 0 0 0 0 0 0 0 0 0 0 0 0 0 0 0
0 0 0 0 0 0 0 0 0 0 0 0 0 0 0 0 0 0 0 0

0 0 0 0 0 0 0 0 0 0 0 0 0 0 0 0 0 0 0 0
0 0 0 0 0 0 0 0 0 0 0 0 0 0 0 0 0 0 0 0
0 0 0 0 0 0 0 0 0 0 0 0 0 0 0 0 0 0 0 0
0 0 0 0 0 0 0 0 0 0 0 0 0 0 0 0 0 0 0 0
0 0 0 0 0 0 112 103 112 103 103 0 0 0 0 0 0 0 0 0
0 0 0 0 0 103 112 0 0 0 103 103 112 112 0 0 0 0 0 0
0 0 0 0 112 112 120 0 0 0 119 0 0 112 112 112 112 103 112 112
0 0 0 0 112 120 128 0 0 0 127 0 0 120 0 0 0 0 0 0
0 0 0 0 112 128 0 0 0 0 0 0 0 128 0 0 0 0 0 0
0 0 0 0 112 0 0 0 0 0 0 0 0 0 0 0 0 0 0 0
0 0 0 0 112 0 0 0 0 0 0 0 0 0 0 0 0 0 0 0
0 0 0 0 112 0 0 0 0 0 0 0 0 0 0 0 0 0 0 0
0 0 0 0 112 112 0 103 112 103 103 103 112 112 112 112 112 103 112 112
271 271 271 271 271 271 271 271 271 271 271 271 271 0 0 0 0 0 0 0
279 279 279 279 279 279 279 279 279 279 279 279 279 280 0 0 0 0 0 0

0 33 34 35 36 37 38 0 0 0 0 0 0 0 0 0 0 34 35 36
0 41 42 43 44 45 46 0 0 0 0 0 0 0 0 0 41 42 43 44
0 49 50 51 52 53 54 0 0 33 0 0 0 0 0 70 49 50 51 52
0 57 58 59 60 61 62 0 0 0 0 0 0 0 0 0 57 58 59 60
0 65 66 67 68 69 70 0 0 0 0 0 0 0 0 0 65 66 67 68
0 0 0 0 0 0 0 0 0 0 0 0 0 0 0 0 0 0 0 0
34 35 36 37 38 0 0 0 0 65 0 0 0 0 70 0 0 0 0 0
42 43 44 45 46 0 0 0 0 0 0 0 0 0 0 0 0 0 0 0
50 51 52 53 54 0 0 0 0 0 0 0 0 0 0 0 0 0 0 0
58 59 60 61 62 0 0 0 0 0 0 0 0 0 0 0 0 0 0 0
66 67 68 69 70 0 0 0 0 0 0 0 0 0 0 0 0 0 0 0
0 0 0 0 0 0 0 0 0 0 0 0 0 0 0 0 0 0 0 0
0 0 0 0 0 0 0 0 0 0 0 0 0 0 0 0 0 0 0 0
0 0 0 0 0 0 0 0 0 0 0 0 0 0 0 0 0 0 0 0
0 0 0 0 0 0 0 0 0 0 0 0 0 0 0 0 0 0 0 0

