house3_room5 61
9 11
6
1 room-01-udw
1113 add_more
1625 room-01-udy
2041 room-01-udz
2937 room-01-ud
3305 room-01-udw2a
6
0 0 0 0 0 0 0 0 0
0 0 0 0 0 0 0 0 0
1424 1424 1424 1424 1424 1424 1424 1424 1424
0 1424 1424 1424 1424 1424 1424 1424 1424
1424 1424 1424 1424 1424 1424 1424 1424 1424
1424 1424 1424 1424 1424 1424 1424 1424 1424
1424 1424 1424 1424 1424 1424 1424 1424 1424
1424 1424 1424 1424 1424 1424 1424 1424 1424
0 0 1424 1424 1424 1424 1424 1424 1424
0 0 1424 1424 1424 1424 1424 1424 1424
0 0 0 0 0 0 0 0 1424

1430 1430 1430 1430 1430 1430 1430 1430 1430
1446 1446 1446 1446 1446 1446 1446 1446 1446
1 1 1 1 1 1 1 2 3
1 2 3 4 1 2 3 4 1
1 2 3 4 1 109 4 4 1
1 1 1 2 3 1 2 3 1
1 2 1 2 1 1 2 3 1
1 2 1 1 1 1 2 3 1
1 1 1 1 2 1 2 3 1
1 126 3 4 1 1 2 4 4
0 0 0 0 0 0 0 0 4

3065 3066 3067 3068 0 0 0 0 0
3073 3074 3075 3076 0 0 0 0 0
3081 3082 3083 3084 0 0 0 0 0
3100 0 0 0 0 0 0 0 0
0 0 0 0 0 0 0 0 0
0 0 0 0 0 0 0 0 0
0 0 0 0 0 0 0 0 0
0 0 0 0 0 0 0 0 0
83 84 0 0 0 0 0 0 0
77 78 0 0 0 0 0 0 0
0 0 0 0 0 0 0 0 0

0 0 0 0 0 0 0 0 0
0 0 0 0 0 0 0 0 0
0 0 0 0 0 0 0 0 0
3092 0 0 0 0 0 0 0 0
0 0 0 0 0 0 0 0 0
0 0 0 0 0 0 0 0 0
0 0 0 0 0 0 0 0 0
0 0 0 0 0 0 0 0 0
0 0 0 0 0 0 0 0 0
87 88 0 0 0 0 0 0 0
0 0 0 0 0 0 0 0 0

0 0 0 0 0 0 0 0 0
0 0 0 0 0 0 0 0 0
0 0 0 0 0 0 0 0 0
0 0 0 0 0 0 0 0 0
0 0 0 0 0 0 0 0 0
0 0 0 0 0 0 0 0 0
0 0 0 0 0 0 0 0 0
3035 3036 0 0 0 0 0 0 0
0 0 0 0 0 0 0 0 0
0 0 0 0 0 0 0 0 0
0 0 0 0 0 0 0 0 0

3305 3306 3307 3308 3309 3310 3311 3312 3312
3313 3314 3315 3316 3317 3318 3319 3320 3320
3321 3322 3323 3324 3325 3326 3327 3328 3335
3329 3330 3331 3332 3333 3334 3335 3336 3409
3337 3338 3339 3333 3341 3335 3335 3344 3417
3345 3346 3333 3333 3335 3335 3335 3335 3425
3353 3354 3335 3335 3335 3335 3335 3335 3433
3361 3362 3335 3335 3335 3335 3335 3335 3441
3369 3370 3335 3335 3335 3335 3335 3335 3449
3377 3378 3379 3380 3335 3335 3335 3384 3457
0 0 0 0 0 0 0 0 3465

