ouside1_2 64
20 29
2
1 003-Forest01
409 add_more
6
0 0 0 0 0 0 0 0 0 0 0 0 0 0 0 0 0 0 0 0
0 0 0 0 0 0 0 0 0 0 0 0 0 0 0 0 0 0 0 0
0 0 0 0 0 0 0 0 0 0 0 0 0 0 0 0 0 0 0 0
0 0 0 0 0 0 0 0 0 0 0 0 0 0 0 0 0 0 0 0
0 0 0 0 0 0 0 0 0 0 0 0 0 0 0 0 0 0 0 0
0 0 0 0 0 0 0 0 0 0 0 0 0 0 0 0 0 0 0 0
0 0 0 0 0 0 0 0 0 0 0 0 0 0 0 0 0 0 0 0
0 0 0 0 720 720 720 720 0 0 0 0 0 0 0 0 0 0 0 0
720 720 720 720 720 720 720 720 720 720 0 0 0 0 0 0 0 0 0 0
720 720 720 720 720 720 720 720 720 720 720 0 0 0 0 0 0 0 0 0
720 720 720 720 720 720 720 720 720 720 720 720 0 0 0 0 0 0 0 0
720 720 720 720 720 720 720 720 720 720 720 720 0 0 0 0 0 0 0 0
0 0 0 0 720 720 720 720 720 720 720 720 0 0 0 0 0 0 0 0
0 0 0 0 0 0 720 720 720 720 720 720 0 0 0 0 0 0 0 0
0 0 0 0 0 0 720 720 720 720 720 720 0 0 0 0 0 0 0 0
0 0 0 0 0 0 720 720 720 720 720 720 720 0 0 0 0 0 0 0
0 0 0 0 0 0 720 720 720 720 720 720 720 0 0 0 0 0 0 0
0 0 0 0 0 0 720 720 720 720 720 720 0 0 0 0 0 0 0 0
0 0 0 0 0 0 720 720 720 720 720 720 0 0 0 0 0 0 0 0
0 0 0 0 0 720 720 720 720 720 720 720 0 0 0 0 0 0 0 0
0 0 0 0 0 720 720 720 720 720 720 720 0 0 0 0 0 0 0 0
0 0 0 0 0 720 720 720 720 720 720 0 0 0 0 0 0 0 0 0
0 0 0 0 0 0 720 720 720 720 720 0 0 0 0 0 0 0 0 0
0 0 0 0 0 0 720 720 720 720 720 0 0 0 0 0 0 0 0 0
0 0 0 0 0 0 0 720 0 0 0 0 0 0 0 0 0 0 0 0
0 0 0 0 0 0 0 720 0 0 0 0 0 0 0 0 0 0 0 0
0 0 0 0 0 0 0 0 0 0 0 0 0 0 0 0 0 0 0 0
0 0 0 0 0 0 0 0 0 0 0 0 0 0 0 0 0 0 0 0
0 0 0 0 0 0 0 0 0 0 0 0 0 0 0 0 0 0 0 0

3 3 3 3 3 3 3 3 3 3 3 3 3 3 3 3 3 3 3 3
3 3 3 3 3 3 3 3 3 3 3 3 3 3 3 3 3 3 3 3
3 3 3 3 3 3 3 3 3 3 3 3 3 3 3 3 3 3 3 3
3 3 3 3 3 3 3 3 3 3 3 3 3 3 3 3 3 3 3 3
3 3 3 3 3 3 3 3 3 3 3 3 3 3 3 3 3 3 3 3
3 3 3 3 3 3 3 3 3 3 3 3 3 3 3 3 3 3 3 3
1 1 1 3 3 1 1 1 1 3 3 3 3 3 3 3 3 3 3 3
9 9 9 1 1 9 9 9 1 1 1 3 3 3 3 3 3 3 3 3
9 9 9 9 9 9 9 9 9 9 1 1 3 3 3 3 3 3 3 3
9 9 9 9 9 9 9 9 9 9 9 1 1 3 3 3 3 3 3 3
9 9 9 9 9 9 9 9 9 9 9 9 1 3 3 3 3 3 3 3
9 9 9 9 9 9 9 9 9 9 9 9 1 3 3 3 3 3 3 3
1 1 1 9 9 9 9 9 9 9 9 9 1 3 3 3 3 3 3 3
3 3 1 1 1 9 9 9 9 9 9 9 1 3 3 3 3 3 3 3
3 3 3 3 1 1 9 9 9 9 9 9 1 1 3 3 3 3 3 3
3 3 3 3 3 1 9 9 9 9 9 9 9 1 3 3 3 3 3 3
3 3 3 3 3 1 9 9 9 9 9 9 9 1 3 3 3 3 3 3
3 3 3 3 3 1 9 9 9 9 9 9 9 1 1 1 3 3 3 3
3 3 3 3 1 1 9 9 9 9 9 9 9 9 9 1 1 1 1 1
3 3 3 3 1 9 9 9 9 9 9 9 9 9 9 9 9 9 9 9
3 3 3 3 1 9 9 9 9 9 9 9 9 9 9 9 9 9 9 9
3 3 3 3 1 9 9 9 9 9 9 9 9 9 9 9 9 9 9 9
3 3 3 3 1 9 9 9 9 9 9 9 9 9 9 9 9 9 9 9
3 3 3 3 1 1 9 9 9 9 9 9 9 9 9 9 9 9 9 9
3 3 3 3 3 1 9 9 9 9 9 9 9 9 9 9 9 9 9 9
3 3 3 3 3 1 1 9 9 9 9 9 9 9 9 9 9 9 9 9
3 3 3 3 3 3 1 9 9 9 9 9 9 9 9 9 9 9 9 9
3 3 3 3 3 3 1 9 9 9 9 9 9 9 9 9 9 9 9 9
3 3 3 3 3 3 436 436 436 436 436 436 436 436 436 436 436 436 436 436

0 0 0 0 0 0 0 0 0 0 0 0 0 0 0 0 0 0 0 0
0 0 0 0 0 0 0 0 0 0 0 0 0 0 0 0 0 0 0 0
0 0 0 0 0 0 0 0 0 0 0 0 0 0 0 0 0 0 0 0
0 0 0 0 0 0 0 0 0 0 0 0 0 0 0 0 0 0 0 0
0 0 0 112 112 112 112 112 112 0 0 0 0 0 0 0 0 0 0 0
112 112 112 120 120 120 120 120 120 103 112 0 0 0 0 0 0 0 0 0
120 119 119 128 128 128 128 128 128 119 120 112 0 0 0 0 0 0 0 0
128 127 127 128 0 0 0 0 128 127 128 120 112 0 0 0 0 0 0 0
0 0 0 0 0 0 0 0 0 0 128 128 120 0 0 0 0 0 0 0
0 0 0 0 0 0 0 0 0 0 0 128 128 0 0 0 0 0 0 0
0 0 0 0 0 0 0 0 0 0 0 0 128 0 0 0 0 0 0 0
112 112 112 112 0 0 0 0 0 0 0 0 128 0 0 0 0 0 0 0
120 120 120 120 112 112 0 0 0 0 0 0 128 112 0 0 0 0 0 0
128 128 128 128 120 120 0 0 0 0 0 0 128 120 0 0 0 0 0 0
0 0 0 127 128 128 0 0 0 0 0 0 128 128 0 0 0 0 0 0
0 0 0 0 0 128 0 0 0 0 0 0 0 128 0 0 0 0 0 0
0 0 0 0 112 128 0 0 0 0 0 0 112 128 0 0 0 0 0 0
0 0 0 0 120 128 0 0 0 0 0 0 120 128 0 0 0 0 0 0
0 0 0 0 128 128 0 0 0 0 0 0 128 128 0 0 0 0 0 0
0 0 0 0 128 0 0 0 0 0 0 0 128 0 0 0 0 0 0 0
0 0 0 0 128 0 0 0 0 0 0 112 128 0 0 0 0 0 0 0
0 0 0 0 128 112 0 0 0 0 0 120 128 0 0 0 0 0 0 0
0 0 0 0 128 120 0 0 0 0 0 128 128 0 0 0 0 0 0 0
0 0 0 0 128 128 112 0 112 103 112 128 0 0 0 0 0 0 0 0
0 0 0 0 0 128 120 0 120 119 120 128 0 0 0 0 0 0 0 0
0 0 0 0 0 128 128 0 128 127 128 128 0 0 0 0 0 0 0 0
0 0 0 0 0 0 128 0 128 0 0 0 0 0 0 0 0 0 0 0
0 0 0 0 0 0 128 0 128 0 0 0 0 0 0 0 0 0 0 0
0 0 0 0 0 0 0 0 0 0 0 0 0 0 0 0 0 0 0 0

0 0 0 0 0 0 0 0 0 0 0 0 0 0 0 0 0 0 0 0
0 0 0 0 0 0 0 0 0 0 0 0 0 0 0 0 0 0 0 0
0 0 0 0 0 0 0 0 0 0 0 0 0 0 0 0 0 0 0 0
0 0 0 0 0 0 0 0 0 0 0 0 0 0 0 0 0 0 0 0
0 0 0 0 0 0 0 0 0 0 0 0 0 0 0 0 0 0 0 0
0 0 0 112 0 0 0 0 112 0 0 0 0 0 0 0 0 0 0 0
0 0 0 120 0 0 0 0 120 0 112 0 0 0 0 0 0 0 0 0
0 0 0 0 0 0 0 0 0 0 120 112 0 0 0 0 0 0 0 0
0 0 0 0 0 0 0 0 0 0 0 120 112 0 0 0 0 0 0 0
0 0 0 0 0 0 0 0 0 0 0 0 112 0 0 0 0 0 0 0
0 0 0 0 0 0 0 0 0 0 0 0 112 0 0 0 0 0 0 0
0 0 0 0 0 0 0 0 0 0 0 0 112 0 0 0 0 0 0 0
0 0 0 103 0 0 0 0 0 0 0 0 112 0 0 0 0 0 0 0
0 0 0 119 0 112 0 0 0 0 0 0 120 112 0 0 0 0 0 0
0 0 0 0 0 112 0 0 0 0 0 0 0 112 0 0 0 0 0 0
0 0 0 0 0 112 0 0 0 0 0 0 0 112 0 0 0 0 0 0
0 0 0 0 0 112 0 0 0 0 0 0 0 112 0 0 0 0 0 0
0 0 0 0 112 120 0 0 0 0 0 0 112 120 0 0 0 0 0 0
0 0 0 0 103 0 0 0 0 0 0 0 112 0 0 0 0 0 0 0
0 0 0 0 103 0 0 0 0 0 0 0 112 0 0 0 0 0 0 0
0 0 0 0 112 0 0 0 0 0 0 0 112 0 0 0 0 0 0 0
0 0 0 0 112 0 0 0 0 0 0 112 120 0 0 0 0 0 0 0
0 0 0 0 120 112 0 0 0 0 0 112 0 0 0 0 0 0 0 0
0 0 0 0 0 112 0 0 0 0 0 112 0 0 0 0 0 0 0 0
0 0 0 0 0 120 112 0 112 0 0 120 0 0 0 0 0 0 0 0
0 0 0 0 0 0 112 0 112 0 0 0 0 0 0 0 0 0 0 0
0 0 0 0 0 0 120 0 120 0 0 0 0 0 0 0 0 0 0 0
0 0 0 0 0 0 0 0 0 0 0 0 0 0 0 0 0 0 0 0
0 0 0 0 0 0 0 0 0 0 0 0 0 0 0 0 0 0 0 0

0 0 29 0 0 0 0 0 0 0 0 0 0 0 25 26 0 0 0 0
27 28 0 0 0 0 0 0 0 0 0 0 0 0 0 0 0 0 0 0
0 0 0 19 0 0 0 0 27 28 0 0 0 10 0 0 0 0 0 0
0 0 0 65 0 0 0 0 70 0 0 0 0 0 0 0 0 0 0 0
0 31 32 0 0 0 0 0 0 0 0 0 0 0 23 24 0 0 0 0
0 0 0 0 0 0 0 0 0 0 0 0 22 0 0 0 0 0 0 0
0 0 0 0 0 0 0 0 0 0 0 0 30 0 0 0 0 0 0 0
0 0 0 0 0 0 0 0 0 0 0 0 0 0 0 0 0 0 0 21
0 8 0 0 0 0 7 0 0 0 0 0 0 0 0 0 0 0 0 29
0 0 0 0 7 0 6 7 7 0 0 0 0 0 0 0 0 0 0 0
0 0 0 8 0 0 7 0 0 0 0 0 0 0 0 0 0 0 0 0
0 0 0 0 0 0 0 0 0 0 0 0 0 0 0 0 0 0 39 40
0 0 0 0 0 0 0 0 6 0 0 0 0 0 0 0 0 0 0 0
0 0 0 0 0 0 0 0 0 0 0 0 0 0 0 0 0 0 0 0
0 0 0 0 0 0 0 0 0 0 0 7 0 0 0 0 0 0 0 0
0 19 0 0 0 0 0 7 0 0 0 0 0 0 0 0 0 0 0 0
0 0 0 10 0 0 0 7 0 0 0 0 0 0 0 0 0 0 0 0
0 0 0 0 0 0 0 0 0 8 0 0 0 0 0 0 0 0 0 0
0 0 0 21 0 0 0 0 0 0 0 0 0 0 0 0 0 0 0 0
0 0 0 29 0 0 0 8 0 0 0 0 0 0 0 0 0 0 0 0
0 0 0 0 0 0 0 0 0 0 0 0 0 0 6 0 0 0 0 0
0 0 0 0 0 0 8 0 0 8 0 0 0 0 8 7 0 0 10 0
10 0 0 0 0 0 0 0 0 0 0 0 0 0 0 0 0 0 0 0
0 0 0 0 0 0 0 0 0 0 0 0 0 0 0 0 0 0 0 0
0 27 28 0 0 0 0 0 0 0 0 0 0 0 0 0 0 0 0 0
0 0 0 0 0 0 0 0 0 0 0 0 0 0 0 0 0 0 0 0
0 0 0 0 0 0 0 0 0 0 0 0 0 0 0 0 0 0 0 0
0 0 0 0 0 0 0 0 0 0 0 0 0 0 0 0 0 0 0 0
0 0 0 0 0 0 0 0 0 0 0 0 0 0 0 0 0 0 0 0

45 46 0 0 41 42 43 44 45 46 0 0 0 0 0 0 0 0 0 0
53 54 0 0 49 50 51 52 53 54 0 0 0 0 0 33 34 35 36 37
61 62 0 0 57 58 59 60 61 62 0 0 0 0 0 41 42 43 44 45
69 70 0 0 65 66 67 68 69 70 0 0 0 0 0 49 50 51 52 53
0 0 0 0 0 0 0 0 0 0 0 0 0 0 0 57 58 59 60 61
0 0 0 0 0 0 0 0 0 0 0 0 0 0 0 65 66 67 68 69
0 0 0 0 0 0 0 0 0 0 0 0 0 0 0 0 0 0 0 0
0 0 0 0 0 0 0 0 0 0 0 0 0 0 0 0 0 0 0 0
0 0 0 0 0 0 0 0 0 0 0 0 0 0 0 0 0 0 0 0
0 0 0 0 0 0 0 0 0 0 0 0 0 0 0 0 0 0 0 0
0 0 0 0 0 0 0 0 0 0 0 0 0 0 0 0 0 0 0 0
0 0 0 0 0 0 0 0 0 0 0 0 0 0 0 0 0 0 0 0
0 0 0 0 0 0 0 0 0 0 0 0 0 0 33 34 35 36 37 38
0 0 0 0 0 0 0 0 0 0 0 0 0 0 41 42 43 44 45 46
0 0 0 0 0 0 0 0 0 0 0 0 0 0 49 50 51 52 53 54
0 0 0 0 0 0 0 0 0 0 0 0 0 0 57 58 59 60 61 62
0 0 0 0 0 0 0 0 0 0 0 0 0 0 65 66 67 68 69 70
36 37 38 0 0 0 0 0 0 0 0 0 0 0 0 0 0 0 0 0
44 45 46 0 0 0 0 0 0 0 0 0 0 0 0 0 0 0 0 0
52 53 54 0 0 0 0 0 0 0 0 0 0 0 0 0 0 0 0 0
60 61 62 0 0 0 0 0 0 0 0 0 0 0 0 0 0 0 0 0
68 69 70 0 0 0 0 0 0 0 0 0 0 0 0 0 0 0 0 0
0 0 0 0 0 0 0 0 0 0 0 0 0 0 0 0 0 0 0 0
0 0 0 0 0 0 0 0 0 0 0 0 0 0 0 0 0 0 0 0
0 0 0 0 0 0 0 0 0 0 0 0 0 0 0 0 0 0 0 0
0 0 0 0 0 0 0 0 0 0 0 0 0 0 0 0 0 0 0 0
35 36 37 38 0 0 0 0 0 0 0 0 0 0 0 0 0 0 0 0
43 44 45 46 0 397 398 398 398 398 398 398 398 398 398 398 398 398 398 398
51 52 53 54 0 405 406 406 406 406 406 406 406 406 406 406 406 406 406 406

