house1_hallway3
10 14
2
1 add_more
513 room-01-udy
5
0 0 0 0 0 0 0 0 0 0
0 0 0 0 0 0 0 0 0 0
312 312 312 312 312 312 312 312 312 312
312 312 312 312 312 312 312 312 312 312
0 0 0 312 312 312 312 0 0 0
0 0 0 312 312 0 0 0 0 0
0 0 0 312 312 0 0 0 0 0
0 0 0 312 312 0 0 0 0 0
0 0 0 312 312 0 0 0 0 0
0 0 0 312 312 0 0 0 0 0
0 0 0 312 312 0 0 0 312 312
0 0 0 312 312 312 312 312 312 312
312 312 312 312 312 312 312 312 312 312
312 312 312 312 312 312 312 312 312 312

12 12 12 12 12 12 12 12 12 12
12 12 12 12 12 12 12 12 12 12
513 514 515 516 513 514 515 516 513 514
513 514 515 516 513 514 515 516 513 514
28 28 28 516 513 514 515 28 28 28
28 28 28 516 513 28 28 28 28 28
28 28 28 516 513 28 28 28 28 28
28 28 28 516 513 28 28 28 28 28
28 28 28 516 513 28 28 28 28 28
28 28 28 516 513 28 28 12 28 28
12 12 12 516 513 15 15 12 28 28
12 12 12 516 513 514 515 516 513 514
513 514 515 516 513 514 515 516 513 514
513 514 515 516 513 514 515 516 513 514

521 521 521 521 521 521 521 521 521 521
529 529 529 529 529 529 529 529 529 529
0 0 0 0 0 0 0 0 0 0
0 0 0 0 0 0 0 0 0 0
0 0 0 0 0 0 0 0 0 0
0 0 0 0 0 0 0 0 0 0
0 0 0 0 0 0 0 0 0 0
0 0 0 0 0 0 0 0 0 0
0 0 0 0 0 0 0 0 0 0
0 0 0 0 0 0 0 521 0 0
521 521 521 0 0 529 529 529 0 0
529 529 529 0 0 0 0 0 0 0
0 0 0 0 0 0 0 0 0 0
0 0 0 0 0 0 0 0 0 0

0 9 0 0 79 0 0 0 9 0
0 25 0 0 95 0 0 0 25 0
0 0 0 0 0 0 0 0 0 0
0 0 0 0 0 0 0 0 0 0
0 0 0 0 0 0 0 0 0 0
0 0 0 0 0 569 569 0 0 0
0 0 0 0 0 569 569 0 569 569
0 0 0 0 0 569 569 0 569 569
0 0 0 0 0 569 569 0 569 569
0 0 0 0 0 577 577 0 569 569
0 9 0 0 0 0 0 0 569 569
0 25 0 0 0 0 0 0 577 577
0 0 0 0 0 0 0 0 0 0
0 0 0 0 0 0 0 0 0 0

0 0 0 0 0 0 0 0 0 0
0 0 0 0 0 0 0 0 0 0
0 0 0 0 0 0 0 0 0 0
0 0 0 0 0 0 0 0 0 0
0 0 0 0 0 552 0 0 0 0
0 0 0 0 0 557 0 0 0 0
0 0 0 0 0 557 0 0 0 0
0 0 0 0 0 557 0 0 0 0
0 0 0 0 0 557 0 0 0 0
0 0 0 0 0 557 0 0 0 0
0 0 0 0 0 565 566 559 0 0
0 0 0 0 0 0 0 575 0 0
0 0 0 0 0 0 0 0 0 0
0 0 0 0 0 0 0 0 0 0

