house1_hallway5
11 6
2
1 add_more
513 room-01-udy
4
0 0 0 0 0 0 0 0 0 0 0
0 0 0 0 0 0 0 0 0 0 0
312 312 312 312 312 312 312 312 312 312 312
312 312 312 312 312 312 312 312 312 312 312
312 312 312 312 312 312 312 312 312 312 312
0 0 0 0 0 0 312 0 0 0 0

12 12 12 12 12 12 12 12 12 12 12
12 12 12 12 12 12 12 12 12 12 12
513 514 515 516 513 514 515 516 513 514 515
513 514 515 516 513 514 515 516 513 514 515
513 514 515 516 513 514 515 516 513 514 515
28 28 28 28 28 28 515 28 28 28 28

521 521 521 521 521 521 521 521 521 521 521
529 529 529 529 529 529 529 529 529 529 529
0 0 0 0 0 0 0 0 0 0 0
0 0 0 0 0 0 0 0 0 0 0
0 0 0 0 0 0 0 0 0 0 0
0 0 0 0 0 0 0 0 0 0 0

0 0 9 0 0 0 0 0 0 0 0
0 0 25 0 0 0 0 0 0 0 0
0 0 0 0 0 0 0 0 0 0 0
0 0 0 0 0 0 0 0 0 0 0
0 0 0 0 0 0 0 0 0 0 0
0 0 0 0 0 0 0 0 0 0 0

