33
1 2 13 0 192 6 320 64
1 2 6 320 96 13 0 224
1 2 13 0 256 6 320 128
1 2 6 0 96 19 96 64
1 1 6 96 32 18 160 128
1 1 13 160 32 9 192 160
1 2 9 320 64 10 0 384
1 2 9 320 96 10 0 416
1 2 9 320 128 10 0 448
1 1 10 384 352 21 128 320
1 1 21 32 32 22 32 256
1 2 5 0 64 13 384 192
1 2 13 384 224 5 0 96
1 2 5 0 128 13 384 256
1 2 5 288 96 11 0 288
1 1 5 128 32 12 448 672
1 2 13 256 128 7 160 160
1 2 7 192 160 13 288 128
1 1 20 128 320 7 32 32
1 1 14 128 320 7 256 32
1 1 17 160 352 7 32 352
1 2 7 256 288 8 32 288
1 2 7 288 288 8 64 288
1 1 15 128 352 8 64 32
1 2 8 0 192 16 288 192
2 2 16 64 288 17 64 224
1 1 9 64 32 0 96 544
1 2 0 0 160 1 224 128
1 2 0 416 160 2 0 160
1 2 2 320 160 3 0 256
1 1 2 160 32 4 32 320
1 1 4 32 32 36 192 320
1 2 36 0 192 43 224 224
